,index,Date,Team1,PTS1,Team2,PTS2,MOV
0,0,Tue Oct 25 2016,New York Knicks,88,Cleveland Cavaliers,117,-29
849,0,Tue Oct 25 2016,Cleveland Cavaliers,117,New York Knicks,88,29
1,1,Tue Oct 25 2016,San Antonio Spurs,129,Golden State Warriors,100,29
850,1,Tue Oct 25 2016,Golden State Warriors,100,San Antonio Spurs,129,-29
2,2,Tue Oct 25 2016,Utah Jazz,104,Portland Trail Blazers,113,-9
851,2,Tue Oct 25 2016,Portland Trail Blazers,113,Utah Jazz,104,9
3,3,Wed Oct 26 2016,Brooklyn Nets,117,Boston Celtics,122,-5
852,3,Wed Oct 26 2016,Boston Celtics,122,Brooklyn Nets,117,5
4,4,Wed Oct 26 2016,Dallas Mavericks,121,Indiana Pacers,130,-9
853,4,Wed Oct 26 2016,Indiana Pacers,130,Dallas Mavericks,121,9
5,5,Wed Oct 26 2016,Houston Rockets,114,Los Angeles Lakers,120,-6
854,5,Wed Oct 26 2016,Los Angeles Lakers,120,Houston Rockets,114,6
6,6,Wed Oct 26 2016,Minnesota Timberwolves,98,Memphis Grizzlies,102,-4
855,6,Wed Oct 26 2016,Memphis Grizzlies,102,Minnesota Timberwolves,98,4
856,7,Wed Oct 26 2016,Milwaukee Bucks,96,Charlotte Hornets,107,-11
7,7,Wed Oct 26 2016,Charlotte Hornets,107,Milwaukee Bucks,96,11
857,8,Wed Oct 26 2016,New Orleans Pelicans,102,Denver Nuggets,107,-5
8,8,Wed Oct 26 2016,Denver Nuggets,107,New Orleans Pelicans,102,5
858,9,Wed Oct 26 2016,Orlando Magic,96,Miami Heat,108,-12
9,9,Wed Oct 26 2016,Miami Heat,108,Orlando Magic,96,12
859,10,Wed Oct 26 2016,Philadelphia 76ers,97,Oklahoma City Thunder,103,-6
10,10,Wed Oct 26 2016,Oklahoma City Thunder,103,Philadelphia 76ers,97,6
11,11,Wed Oct 26 2016,Sacramento Kings,113,Phoenix Suns,94,19
860,11,Wed Oct 26 2016,Phoenix Suns,94,Sacramento Kings,113,-19
12,12,Wed Oct 26 2016,Detroit Pistons,91,Toronto Raptors,109,-18
861,12,Wed Oct 26 2016,Toronto Raptors,109,Detroit Pistons,91,18
13,13,Thu Oct 27 2016,Washington Wizards,99,Atlanta Hawks,114,-15
862,13,Thu Oct 27 2016,Atlanta Hawks,114,Washington Wizards,99,15
14,14,Thu Oct 27 2016,Boston Celtics,99,Chicago Bulls,105,-6
863,14,Thu Oct 27 2016,Chicago Bulls,105,Boston Celtics,99,6
864,15,Thu Oct 27 2016,Portland Trail Blazers,106,Los Angeles Clippers,114,-8
15,15,Thu Oct 27 2016,Los Angeles Clippers,114,Portland Trail Blazers,106,8
16,16,Thu Oct 27 2016,San Antonio Spurs,102,Sacramento Kings,94,8
865,16,Thu Oct 27 2016,Sacramento Kings,94,San Antonio Spurs,102,-8
866,17,Fri Oct 28 2016,Brooklyn Nets,103,Indiana Pacers,94,9
17,17,Fri Oct 28 2016,Indiana Pacers,94,Brooklyn Nets,103,-9
18,18,Fri Oct 28 2016,Houston Rockets,106,Dallas Mavericks,98,8
867,18,Fri Oct 28 2016,Dallas Mavericks,98,Houston Rockets,106,-8
868,19,Fri Oct 28 2016,Detroit Pistons,108,Orlando Magic,82,26
19,19,Fri Oct 28 2016,Orlando Magic,82,Detroit Pistons,108,-26
20,20,Fri Oct 28 2016,Charlotte Hornets,97,Miami Heat,91,6
869,20,Fri Oct 28 2016,Miami Heat,91,Charlotte Hornets,97,-6
21,21,Fri Oct 28 2016,Golden State Warriors,122,New Orleans Pelicans,114,8
870,21,Fri Oct 28 2016,New Orleans Pelicans,114,Golden State Warriors,122,-8
22,22,Fri Oct 28 2016,Phoenix Suns,110,Oklahoma City Thunder,113,-3
871,22,Fri Oct 28 2016,Oklahoma City Thunder,113,Phoenix Suns,110,3
872,23,Fri Oct 28 2016,Toronto Raptors,91,Cleveland Cavaliers,94,-3
23,23,Fri Oct 28 2016,Cleveland Cavaliers,94,Toronto Raptors,91,3
873,24,Fri Oct 28 2016,Utah Jazz,96,Los Angeles Lakers,89,7
24,24,Fri Oct 28 2016,Los Angeles Lakers,89,Utah Jazz,96,-7
874,25,Sat Oct 29 2016,Chicago Bulls,118,Indiana Pacers,101,17
25,25,Sat Oct 29 2016,Indiana Pacers,101,Chicago Bulls,118,-17
26,26,Sat Oct 29 2016,Boston Celtics,104,Charlotte Hornets,98,6
875,26,Sat Oct 29 2016,Charlotte Hornets,98,Boston Celtics,104,-6
876,27,Sat Oct 29 2016,Cleveland Cavaliers,105,Orlando Magic,99,6
27,27,Sat Oct 29 2016,Orlando Magic,99,Cleveland Cavaliers,105,-6
877,28,Sat Oct 29 2016,Denver Nuggets,113,Portland Trail Blazers,115,-2
28,28,Sat Oct 29 2016,Portland Trail Blazers,115,Denver Nuggets,113,2
878,29,Sat Oct 29 2016,Milwaukee Bucks,110,Brooklyn Nets,108,2
29,29,Sat Oct 29 2016,Brooklyn Nets,108,Milwaukee Bucks,110,-2
30,30,Sat Oct 29 2016,Memphis Grizzlies,104,New York Knicks,111,-7
879,30,Sat Oct 29 2016,New York Knicks,111,Memphis Grizzlies,104,7
31,31,Sat Oct 29 2016,Atlanta Hawks,104,Philadelphia 76ers,72,32
880,31,Sat Oct 29 2016,Philadelphia 76ers,72,Atlanta Hawks,104,-32
881,32,Sat Oct 29 2016,Sacramento Kings,106,Minnesota Timberwolves,103,3
32,32,Sat Oct 29 2016,Minnesota Timberwolves,103,Sacramento Kings,106,-3
33,33,Sat Oct 29 2016,New Orleans Pelicans,79,San Antonio Spurs,98,-19
882,33,Sat Oct 29 2016,San Antonio Spurs,98,New Orleans Pelicans,79,19
34,34,Sun Oct 30 2016,Milwaukee Bucks,83,Detroit Pistons,98,-15
883,34,Sun Oct 30 2016,Detroit Pistons,98,Milwaukee Bucks,83,15
35,35,Sun Oct 30 2016,Dallas Mavericks,92,Houston Rockets,93,-1
884,35,Sun Oct 30 2016,Houston Rockets,93,Dallas Mavericks,92,1
885,36,Sun Oct 30 2016,Los Angeles Clippers,88,Utah Jazz,75,13
36,36,Sun Oct 30 2016,Utah Jazz,75,Los Angeles Clippers,88,-13
37,37,Sun Oct 30 2016,Washington Wizards,103,Memphis Grizzlies,112,-9
886,37,Sun Oct 30 2016,Memphis Grizzlies,112,Washington Wizards,103,9
38,38,Sun Oct 30 2016,San Antonio Spurs,106,Miami Heat,99,7
887,38,Sun Oct 30 2016,Miami Heat,99,San Antonio Spurs,106,-7
39,39,Sun Oct 30 2016,Los Angeles Lakers,96,Oklahoma City Thunder,113,-17
888,39,Sun Oct 30 2016,Oklahoma City Thunder,113,Los Angeles Lakers,96,17
40,40,Sun Oct 30 2016,Golden State Warriors,106,Phoenix Suns,100,6
889,40,Sun Oct 30 2016,Phoenix Suns,100,Golden State Warriors,106,-6
890,41,Mon Oct 31 2016,Atlanta Hawks,106,Sacramento Kings,95,11
41,41,Mon Oct 31 2016,Sacramento Kings,95,Atlanta Hawks,106,-11
891,42,Mon Oct 31 2016,Brooklyn Nets,88,Chicago Bulls,118,-30
42,42,Mon Oct 31 2016,Chicago Bulls,118,Brooklyn Nets,88,30
43,43,Mon Oct 31 2016,Phoenix Suns,98,Los Angeles Clippers,116,-18
892,43,Mon Oct 31 2016,Los Angeles Clippers,116,Phoenix Suns,98,18
893,44,Mon Oct 31 2016,Toronto Raptors,105,Denver Nuggets,102,3
44,44,Mon Oct 31 2016,Denver Nuggets,102,Toronto Raptors,105,-3
45,45,Tue Nov 1 2016,Houston Rockets,120,Cleveland Cavaliers,128,-8
894,45,Tue Nov 1 2016,Cleveland Cavaliers,128,Houston Rockets,120,8
46,46,Tue Nov 1 2016,New York Knicks,89,Detroit Pistons,102,-13
895,46,Tue Nov 1 2016,Detroit Pistons,102,New York Knicks,89,13
47,47,Tue Nov 1 2016,Los Angeles Lakers,108,Indiana Pacers,115,-7
896,47,Tue Nov 1 2016,Indiana Pacers,115,Los Angeles Lakers,108,7
48,48,Tue Nov 1 2016,Sacramento Kings,96,Miami Heat,108,-12
897,48,Tue Nov 1 2016,Miami Heat,108,Sacramento Kings,96,12
49,49,Tue Nov 1 2016,Memphis Grizzlies,80,Minnesota Timberwolves,116,-36
898,49,Tue Nov 1 2016,Minnesota Timberwolves,116,Memphis Grizzlies,80,36
899,50,Tue Nov 1 2016,New Orleans Pelicans,113,Milwaukee Bucks,117,-4
50,50,Tue Nov 1 2016,Milwaukee Bucks,117,New Orleans Pelicans,113,4
900,51,Tue Nov 1 2016,Philadelphia 76ers,101,Orlando Magic,103,-2
51,51,Tue Nov 1 2016,Orlando Magic,103,Philadelphia 76ers,101,2
901,52,Tue Nov 1 2016,Portland Trail Blazers,104,Golden State Warriors,127,-23
52,52,Tue Nov 1 2016,Golden State Warriors,127,Portland Trail Blazers,104,23
902,53,Tue Nov 1 2016,San Antonio Spurs,91,Utah Jazz,106,-15
53,53,Tue Nov 1 2016,Utah Jazz,106,San Antonio Spurs,91,15
903,54,Wed Nov 2 2016,Atlanta Hawks,116,Los Angeles Lakers,123,-7
54,54,Wed Nov 2 2016,Los Angeles Lakers,123,Atlanta Hawks,116,7
904,55,Wed Nov 2 2016,Boston Celtics,107,Chicago Bulls,100,7
55,55,Wed Nov 2 2016,Chicago Bulls,100,Boston Celtics,107,-7
56,56,Wed Nov 2 2016,Detroit Pistons,101,Brooklyn Nets,109,-8
905,56,Wed Nov 2 2016,Brooklyn Nets,109,Detroit Pistons,101,8
57,57,Wed Nov 2 2016,Philadelphia 76ers,93,Charlotte Hornets,109,-16
906,57,Wed Nov 2 2016,Charlotte Hornets,109,Philadelphia 76ers,93,16
58,58,Wed Nov 2 2016,Oklahoma City Thunder,85,Los Angeles Clippers,83,2
907,58,Wed Nov 2 2016,Los Angeles Clippers,83,Oklahoma City Thunder,85,-2
59,59,Wed Nov 2 2016,New Orleans Pelicans,83,Memphis Grizzlies,89,-6
908,59,Wed Nov 2 2016,Memphis Grizzlies,89,New Orleans Pelicans,83,6
909,60,Wed Nov 2 2016,New York Knicks,99,Houston Rockets,118,-19
60,60,Wed Nov 2 2016,Houston Rockets,118,New York Knicks,99,19
61,61,Wed Nov 2 2016,Portland Trail Blazers,115,Phoenix Suns,118,-3
910,61,Wed Nov 2 2016,Phoenix Suns,118,Portland Trail Blazers,115,3
62,62,Wed Nov 2 2016,Dallas Mavericks,81,Utah Jazz,97,-16
911,62,Wed Nov 2 2016,Utah Jazz,97,Dallas Mavericks,81,16
63,63,Wed Nov 2 2016,Toronto Raptors,113,Washington Wizards,103,10
912,63,Wed Nov 2 2016,Washington Wizards,103,Toronto Raptors,113,-10
64,64,Thu Nov 3 2016,Boston Celtics,122,Cleveland Cavaliers,128,-6
913,64,Thu Nov 3 2016,Cleveland Cavaliers,128,Boston Celtics,122,6
914,65,Thu Nov 3 2016,Golden State Warriors,122,Oklahoma City Thunder,96,26
65,65,Thu Nov 3 2016,Oklahoma City Thunder,96,Golden State Warriors,122,-26
66,66,Thu Nov 3 2016,Indiana Pacers,107,Milwaukee Bucks,125,-18
915,66,Thu Nov 3 2016,Milwaukee Bucks,125,Indiana Pacers,107,18
916,67,Thu Nov 3 2016,Minnesota Timberwolves,99,Denver Nuggets,102,-3
67,67,Thu Nov 3 2016,Denver Nuggets,102,Minnesota Timberwolves,99,3
68,68,Thu Nov 3 2016,Sacramento Kings,94,Orlando Magic,102,-8
917,68,Thu Nov 3 2016,Orlando Magic,102,Sacramento Kings,94,8
918,69,Fri Nov 4 2016,Brooklyn Nets,95,Charlotte Hornets,99,-4
69,69,Fri Nov 4 2016,Charlotte Hornets,99,Brooklyn Nets,95,4
919,70,Fri Nov 4 2016,Chicago Bulls,104,New York Knicks,117,-13
70,70,Fri Nov 4 2016,New York Knicks,117,Chicago Bulls,104,13
920,71,Fri Nov 4 2016,Dallas Mavericks,95,Portland Trail Blazers,105,-10
71,71,Fri Nov 4 2016,Portland Trail Blazers,105,Dallas Mavericks,95,10
72,72,Fri Nov 4 2016,Golden State Warriors,97,Los Angeles Lakers,117,-20
921,72,Fri Nov 4 2016,Los Angeles Lakers,117,Golden State Warriors,97,20
73,73,Fri Nov 4 2016,Los Angeles Clippers,99,Memphis Grizzlies,88,11
922,73,Fri Nov 4 2016,Memphis Grizzlies,88,Los Angeles Clippers,99,-11
923,74,Fri Nov 4 2016,New Orleans Pelicans,111,Phoenix Suns,112,-1
74,74,Fri Nov 4 2016,Phoenix Suns,112,New Orleans Pelicans,111,1
75,75,Fri Nov 4 2016,Miami Heat,87,Toronto Raptors,96,-9
924,75,Fri Nov 4 2016,Toronto Raptors,96,Miami Heat,87,9
76,76,Fri Nov 4 2016,San Antonio Spurs,100,Utah Jazz,86,14
925,76,Fri Nov 4 2016,Utah Jazz,86,San Antonio Spurs,100,-14
77,77,Fri Nov 4 2016,Atlanta Hawks,92,Washington Wizards,95,-3
926,77,Fri Nov 4 2016,Washington Wizards,95,Atlanta Hawks,92,3
78,78,Sat Nov 5 2016,Houston Rockets,97,Atlanta Hawks,112,-15
927,78,Sat Nov 5 2016,Atlanta Hawks,112,Houston Rockets,97,15
928,79,Sat Nov 5 2016,Detroit Pistons,103,Denver Nuggets,86,17
79,79,Sat Nov 5 2016,Denver Nuggets,86,Detroit Pistons,103,-17
929,80,Sat Nov 5 2016,Indiana Pacers,111,Chicago Bulls,94,17
80,80,Sat Nov 5 2016,Chicago Bulls,94,Indiana Pacers,111,-17
930,81,Sat Nov 5 2016,Milwaukee Bucks,117,Sacramento Kings,91,26
81,81,Sat Nov 5 2016,Sacramento Kings,91,Milwaukee Bucks,117,-26
82,82,Sat Nov 5 2016,Minnesota Timberwolves,92,Oklahoma City Thunder,112,-20
931,82,Sat Nov 5 2016,Oklahoma City Thunder,112,Minnesota Timberwolves,92,20
83,83,Sat Nov 5 2016,Washington Wizards,86,Orlando Magic,88,-2
932,83,Sat Nov 5 2016,Orlando Magic,88,Washington Wizards,86,2
933,84,Sat Nov 5 2016,Philadelphia 76ers,101,Cleveland Cavaliers,102,-1
84,84,Sat Nov 5 2016,Cleveland Cavaliers,102,Philadelphia 76ers,101,1
934,85,Sat Nov 5 2016,San Antonio Spurs,92,Los Angeles Clippers,116,-24
85,85,Sat Nov 5 2016,Los Angeles Clippers,116,San Antonio Spurs,92,24
86,86,Sun Nov 6 2016,Denver Nuggets,123,Boston Celtics,107,16
935,86,Sun Nov 6 2016,Boston Celtics,107,Denver Nuggets,123,-16
87,87,Sun Nov 6 2016,Milwaukee Bucks,75,Dallas Mavericks,86,-11
936,87,Sun Nov 6 2016,Dallas Mavericks,86,Milwaukee Bucks,75,11
937,88,Sun Nov 6 2016,Los Angeles Lakers,119,Phoenix Suns,108,11
88,88,Sun Nov 6 2016,Phoenix Suns,108,Los Angeles Lakers,119,-11
938,89,Sun Nov 6 2016,Memphis Grizzlies,94,Portland Trail Blazers,100,-6
89,89,Sun Nov 6 2016,Portland Trail Blazers,100,Memphis Grizzlies,94,6
939,90,Sun Nov 6 2016,New York Knicks,109,Utah Jazz,114,-5
90,90,Sun Nov 6 2016,Utah Jazz,114,New York Knicks,109,5
940,91,Sun Nov 6 2016,Toronto Raptors,91,Sacramento Kings,96,-5
91,91,Sun Nov 6 2016,Sacramento Kings,96,Toronto Raptors,91,5
941,92,Mon Nov 7 2016,Chicago Bulls,112,Orlando Magic,80,32
92,92,Mon Nov 7 2016,Orlando Magic,80,Chicago Bulls,112,-32
93,93,Mon Nov 7 2016,Indiana Pacers,100,Charlotte Hornets,122,-22
942,93,Mon Nov 7 2016,Charlotte Hornets,122,Indiana Pacers,100,22
943,94,Mon Nov 7 2016,Golden State Warriors,116,New Orleans Pelicans,106,10
94,94,Mon Nov 7 2016,New Orleans Pelicans,106,Golden State Warriors,116,-10
95,95,Mon Nov 7 2016,Detroit Pistons,82,Los Angeles Clippers,114,-32
944,95,Mon Nov 7 2016,Los Angeles Clippers,114,Detroit Pistons,82,32
96,96,Mon Nov 7 2016,Miami Heat,85,Oklahoma City Thunder,97,-12
945,96,Mon Nov 7 2016,Oklahoma City Thunder,97,Miami Heat,85,12
97,97,Mon Nov 7 2016,Utah Jazz,109,Philadelphia 76ers,84,25
946,97,Mon Nov 7 2016,Philadelphia 76ers,84,Utah Jazz,109,-25
98,98,Mon Nov 7 2016,Houston Rockets,114,Washington Wizards,106,8
947,98,Mon Nov 7 2016,Washington Wizards,106,Houston Rockets,114,-8
99,99,Tue Nov 8 2016,Minnesota Timberwolves,110,Brooklyn Nets,119,-9
948,99,Tue Nov 8 2016,Brooklyn Nets,119,Minnesota Timberwolves,110,9
100,100,Tue Nov 8 2016,Atlanta Hawks,110,Cleveland Cavaliers,106,4
949,100,Tue Nov 8 2016,Cleveland Cavaliers,106,Atlanta Hawks,110,-4
950,101,Tue Nov 8 2016,Los Angeles Lakers,97,Dallas Mavericks,109,-12
101,101,Tue Nov 8 2016,Dallas Mavericks,109,Los Angeles Lakers,97,12
102,102,Tue Nov 8 2016,Denver Nuggets,107,Memphis Grizzlies,108,-1
951,102,Tue Nov 8 2016,Memphis Grizzlies,108,Denver Nuggets,107,1
103,103,Tue Nov 8 2016,Phoenix Suns,121,Portland Trail Blazers,124,-3
952,103,Tue Nov 8 2016,Portland Trail Blazers,124,Phoenix Suns,121,3
953,104,Tue Nov 8 2016,Sacramento Kings,102,New Orleans Pelicans,94,8
104,104,Tue Nov 8 2016,New Orleans Pelicans,94,Sacramento Kings,102,-8
954,105,Wed Nov 9 2016,Atlanta Hawks,115,Chicago Bulls,107,8
105,105,Wed Nov 9 2016,Chicago Bulls,107,Atlanta Hawks,115,-8
955,106,Wed Nov 9 2016,Charlotte Hornets,104,Utah Jazz,98,6
106,106,Wed Nov 9 2016,Utah Jazz,98,Charlotte Hornets,104,-6
956,107,Wed Nov 9 2016,Golden State Warriors,116,Dallas Mavericks,95,21
107,107,Wed Nov 9 2016,Dallas Mavericks,95,Golden State Warriors,116,-21
957,108,Wed Nov 9 2016,Indiana Pacers,122,Philadelphia 76ers,115,7
108,108,Wed Nov 9 2016,Philadelphia 76ers,115,Indiana Pacers,122,-7
109,109,Wed Nov 9 2016,Portland Trail Blazers,80,Los Angeles Clippers,111,-31
958,109,Wed Nov 9 2016,Los Angeles Clippers,111,Portland Trail Blazers,80,31
110,110,Wed Nov 9 2016,Brooklyn Nets,96,New York Knicks,110,-14
959,110,Wed Nov 9 2016,New York Knicks,110,Brooklyn Nets,96,14
111,111,Wed Nov 9 2016,Toronto Raptors,112,Oklahoma City Thunder,102,10
960,111,Wed Nov 9 2016,Oklahoma City Thunder,102,Toronto Raptors,112,-10
112,112,Wed Nov 9 2016,Minnesota Timberwolves,123,Orlando Magic,107,16
961,112,Wed Nov 9 2016,Orlando Magic,107,Minnesota Timberwolves,123,-16
113,113,Wed Nov 9 2016,Detroit Pistons,100,Phoenix Suns,107,-7
962,113,Wed Nov 9 2016,Phoenix Suns,107,Detroit Pistons,100,7
963,114,Wed Nov 9 2016,San Antonio Spurs,99,Houston Rockets,101,-2
114,114,Wed Nov 9 2016,Houston Rockets,101,San Antonio Spurs,99,2
964,115,Wed Nov 9 2016,Washington Wizards,118,Boston Celtics,93,25
115,115,Wed Nov 9 2016,Boston Celtics,93,Washington Wizards,118,-25
965,116,Thu Nov 10 2016,Denver Nuggets,101,Golden State Warriors,125,-24
116,116,Thu Nov 10 2016,Golden State Warriors,125,Denver Nuggets,101,24
966,117,Thu Nov 10 2016,Miami Heat,95,Chicago Bulls,98,-3
117,117,Thu Nov 10 2016,Chicago Bulls,98,Miami Heat,95,3
967,118,Thu Nov 10 2016,Milwaukee Bucks,106,New Orleans Pelicans,112,-6
118,118,Thu Nov 10 2016,New Orleans Pelicans,112,Milwaukee Bucks,106,6
119,119,Thu Nov 10 2016,Los Angeles Lakers,101,Sacramento Kings,91,10
968,119,Thu Nov 10 2016,Sacramento Kings,91,Los Angeles Lakers,101,-10
969,120,Fri Nov 11 2016,Boston Celtics,115,New York Knicks,87,28
120,120,Fri Nov 11 2016,New York Knicks,87,Boston Celtics,115,-28
121,121,Fri Nov 11 2016,Toronto Raptors,113,Charlotte Hornets,111,2
970,121,Fri Nov 11 2016,Charlotte Hornets,111,Toronto Raptors,113,-2
971,122,Fri Nov 11 2016,Oklahoma City Thunder,108,Los Angeles Clippers,110,-2
122,122,Fri Nov 11 2016,Los Angeles Clippers,110,Oklahoma City Thunder,108,2
123,123,Fri Nov 11 2016,Utah Jazz,87,Orlando Magic,74,13
972,123,Fri Nov 11 2016,Orlando Magic,74,Utah Jazz,87,-13
124,124,Fri Nov 11 2016,Indiana Pacers,105,Philadelphia 76ers,109,-4
973,124,Fri Nov 11 2016,Philadelphia 76ers,109,Indiana Pacers,105,4
125,125,Fri Nov 11 2016,Sacramento Kings,120,Portland Trail Blazers,122,-2
974,125,Fri Nov 11 2016,Portland Trail Blazers,122,Sacramento Kings,120,2
126,126,Fri Nov 11 2016,Detroit Pistons,86,San Antonio Spurs,96,-10
975,126,Fri Nov 11 2016,San Antonio Spurs,96,Detroit Pistons,86,10
127,127,Fri Nov 11 2016,Cleveland Cavaliers,105,Washington Wizards,94,11
976,127,Fri Nov 11 2016,Washington Wizards,94,Cleveland Cavaliers,105,-11
977,128,Sat Nov 12 2016,Atlanta Hawks,117,Philadelphia 76ers,96,21
128,128,Sat Nov 12 2016,Philadelphia 76ers,96,Atlanta Hawks,117,-21
129,129,Sat Nov 12 2016,Washington Wizards,95,Chicago Bulls,106,-11
978,129,Sat Nov 12 2016,Chicago Bulls,106,Washington Wizards,95,11
130,130,Sat Nov 12 2016,Detroit Pistons,106,Denver Nuggets,95,11
979,130,Sat Nov 12 2016,Denver Nuggets,95,Detroit Pistons,106,-11
131,131,Sat Nov 12 2016,San Antonio Spurs,106,Houston Rockets,100,6
980,131,Sat Nov 12 2016,Houston Rockets,100,San Antonio Spurs,106,-6
981,132,Sat Nov 12 2016,Indiana Pacers,99,Boston Celtics,105,-6
132,132,Sat Nov 12 2016,Boston Celtics,105,Indiana Pacers,99,6
133,133,Sat Nov 12 2016,Utah Jazz,102,Miami Heat,91,11
982,133,Sat Nov 12 2016,Miami Heat,91,Utah Jazz,102,-11
134,134,Sat Nov 12 2016,Memphis Grizzlies,96,Milwaukee Bucks,106,-10
983,134,Sat Nov 12 2016,Milwaukee Bucks,106,Memphis Grizzlies,96,10
135,135,Sat Nov 12 2016,Los Angeles Clippers,119,Minnesota Timberwolves,105,14
984,135,Sat Nov 12 2016,Minnesota Timberwolves,105,Los Angeles Clippers,119,-14
136,136,Sat Nov 12 2016,Los Angeles Lakers,126,New Orleans Pelicans,99,27
985,136,Sat Nov 12 2016,New Orleans Pelicans,99,Los Angeles Lakers,126,-27
137,137,Sat Nov 12 2016,Brooklyn Nets,122,Phoenix Suns,104,18
986,137,Sat Nov 12 2016,Phoenix Suns,104,Brooklyn Nets,122,-18
987,138,Sat Nov 12 2016,Toronto Raptors,118,New York Knicks,107,11
138,138,Sat Nov 12 2016,New York Knicks,107,Toronto Raptors,118,-11
139,139,Sun Nov 13 2016,Charlotte Hornets,93,Cleveland Cavaliers,100,-7
988,139,Sun Nov 13 2016,Cleveland Cavaliers,100,Charlotte Hornets,93,7
140,140,Sun Nov 13 2016,Phoenix Suns,120,Golden State Warriors,133,-13
989,140,Sun Nov 13 2016,Golden State Warriors,133,Phoenix Suns,120,13
141,141,Sun Nov 13 2016,Los Angeles Lakers,99,Minnesota Timberwolves,125,-26
990,141,Sun Nov 13 2016,Minnesota Timberwolves,125,Los Angeles Lakers,99,26
991,142,Sun Nov 13 2016,Oklahoma City Thunder,117,Orlando Magic,119,-2
142,142,Sun Nov 13 2016,Orlando Magic,119,Oklahoma City Thunder,117,2
143,143,Sun Nov 13 2016,Denver Nuggets,105,Portland Trail Blazers,112,-7
992,143,Sun Nov 13 2016,Portland Trail Blazers,112,Denver Nuggets,105,7
993,144,Mon Nov 14 2016,Detroit Pistons,104,Oklahoma City Thunder,88,16
144,144,Mon Nov 14 2016,Oklahoma City Thunder,88,Detroit Pistons,104,-16
145,145,Mon Nov 14 2016,Philadelphia 76ers,88,Houston Rockets,115,-27
994,145,Mon Nov 14 2016,Houston Rockets,115,Philadelphia 76ers,88,27
146,146,Mon Nov 14 2016,Orlando Magic,69,Indiana Pacers,88,-19
995,146,Mon Nov 14 2016,Indiana Pacers,88,Orlando Magic,69,19
147,147,Mon Nov 14 2016,Brooklyn Nets,95,Los Angeles Clippers,127,-32
996,147,Mon Nov 14 2016,Los Angeles Clippers,127,Brooklyn Nets,95,32
997,148,Mon Nov 14 2016,New Orleans Pelicans,106,Boston Celtics,105,1
148,148,Mon Nov 14 2016,Boston Celtics,105,New Orleans Pelicans,106,-1
149,149,Mon Nov 14 2016,Dallas Mavericks,77,New York Knicks,93,-16
998,149,Mon Nov 14 2016,New York Knicks,93,Dallas Mavericks,77,16
999,150,Mon Nov 14 2016,San Antonio Spurs,94,Miami Heat,90,4
150,150,Mon Nov 14 2016,Miami Heat,90,San Antonio Spurs,94,-4
151,151,Mon Nov 14 2016,Memphis Grizzlies,102,Utah Jazz,96,6
1000,151,Mon Nov 14 2016,Utah Jazz,96,Memphis Grizzlies,102,-6
152,152,Tue Nov 15 2016,Toronto Raptors,117,Cleveland Cavaliers,121,-4
1001,152,Tue Nov 15 2016,Cleveland Cavaliers,121,Toronto Raptors,117,4
153,153,Tue Nov 15 2016,Brooklyn Nets,118,Los Angeles Lakers,125,-7
1002,153,Tue Nov 15 2016,Los Angeles Lakers,125,Brooklyn Nets,118,7
1003,154,Tue Nov 15 2016,Miami Heat,90,Atlanta Hawks,93,-3
154,154,Tue Nov 15 2016,Atlanta Hawks,93,Miami Heat,90,3
155,155,Tue Nov 15 2016,Charlotte Hornets,115,Minnesota Timberwolves,108,7
1004,155,Tue Nov 15 2016,Minnesota Timberwolves,108,Charlotte Hornets,115,-7
1005,156,Tue Nov 15 2016,Portland Trail Blazers,88,Chicago Bulls,113,-25
156,156,Tue Nov 15 2016,Chicago Bulls,113,Portland Trail Blazers,88,25
157,157,Wed Nov 16 2016,Milwaukee Bucks,100,Atlanta Hawks,107,-7
1006,157,Wed Nov 16 2016,Atlanta Hawks,107,Milwaukee Bucks,100,7
1007,158,Wed Nov 16 2016,Boston Celtics,90,Dallas Mavericks,83,7
158,158,Wed Nov 16 2016,Dallas Mavericks,83,Boston Celtics,90,-7
159,159,Wed Nov 16 2016,Phoenix Suns,104,Denver Nuggets,120,-16
1008,159,Wed Nov 16 2016,Denver Nuggets,120,Phoenix Suns,104,16
1009,160,Wed Nov 16 2016,Indiana Pacers,103,Cleveland Cavaliers,93,10
160,160,Wed Nov 16 2016,Cleveland Cavaliers,93,Indiana Pacers,103,-10
1010,161,Wed Nov 16 2016,Los Angeles Clippers,107,Memphis Grizzlies,111,-4
161,161,Wed Nov 16 2016,Memphis Grizzlies,111,Los Angeles Clippers,107,4
1011,162,Wed Nov 16 2016,New York Knicks,105,Detroit Pistons,102,3
162,162,Wed Nov 16 2016,Detroit Pistons,102,New York Knicks,105,-3
1012,163,Wed Nov 16 2016,Oklahoma City Thunder,105,Houston Rockets,103,2
163,163,Wed Nov 16 2016,Houston Rockets,103,Oklahoma City Thunder,105,-2
1013,164,Wed Nov 16 2016,Orlando Magic,89,New Orleans Pelicans,82,7
164,164,Wed Nov 16 2016,New Orleans Pelicans,82,Orlando Magic,89,-7
165,165,Wed Nov 16 2016,Washington Wizards,102,Philadelphia 76ers,109,-7
1014,165,Wed Nov 16 2016,Philadelphia 76ers,109,Washington Wizards,102,7
166,166,Wed Nov 16 2016,San Antonio Spurs,110,Sacramento Kings,105,5
1015,166,Wed Nov 16 2016,Sacramento Kings,105,San Antonio Spurs,110,-5
167,167,Wed Nov 16 2016,Golden State Warriors,127,Toronto Raptors,121,6
1016,167,Wed Nov 16 2016,Toronto Raptors,121,Golden State Warriors,127,-6
1017,168,Thu Nov 17 2016,Houston Rockets,126,Portland Trail Blazers,109,17
168,168,Thu Nov 17 2016,Portland Trail Blazers,109,Houston Rockets,126,-17
169,169,Thu Nov 17 2016,Milwaukee Bucks,73,Miami Heat,96,-23
1018,169,Thu Nov 17 2016,Miami Heat,96,Milwaukee Bucks,73,23
1019,170,Thu Nov 17 2016,Minnesota Timberwolves,110,Philadelphia 76ers,86,24
170,170,Thu Nov 17 2016,Philadelphia 76ers,86,Minnesota Timberwolves,110,-24
1020,171,Thu Nov 17 2016,Utah Jazz,77,Chicago Bulls,85,-8
171,171,Thu Nov 17 2016,Chicago Bulls,85,Utah Jazz,77,8
1021,172,Thu Nov 17 2016,Washington Wizards,119,New York Knicks,112,7
172,172,Thu Nov 17 2016,New York Knicks,112,Washington Wizards,119,-7
1022,173,Fri Nov 18 2016,Boston Celtics,88,Golden State Warriors,104,-16
173,173,Fri Nov 18 2016,Golden State Warriors,104,Boston Celtics,88,16
1023,174,Fri Nov 18 2016,Charlotte Hornets,100,Atlanta Hawks,96,4
174,174,Fri Nov 18 2016,Atlanta Hawks,96,Charlotte Hornets,100,-4
175,175,Fri Nov 18 2016,Detroit Pistons,81,Cleveland Cavaliers,104,-23
1024,175,Fri Nov 18 2016,Cleveland Cavaliers,104,Detroit Pistons,81,23
176,176,Fri Nov 18 2016,Memphis Grizzlies,80,Dallas Mavericks,64,16
1025,176,Fri Nov 18 2016,Dallas Mavericks,64,Memphis Grizzlies,80,-16
1026,177,Fri Nov 18 2016,Denver Nuggets,111,Toronto Raptors,113,-2
177,177,Fri Nov 18 2016,Toronto Raptors,113,Denver Nuggets,111,2
1027,178,Fri Nov 18 2016,Indiana Pacers,96,Phoenix Suns,116,-20
178,178,Fri Nov 18 2016,Phoenix Suns,116,Indiana Pacers,96,20
1028,179,Fri Nov 18 2016,Los Angeles Lakers,107,San Antonio Spurs,116,-9
179,179,Fri Nov 18 2016,San Antonio Spurs,116,Los Angeles Lakers,107,9
180,180,Fri Nov 18 2016,Portland Trail Blazers,101,New Orleans Pelicans,113,-12
1029,180,Fri Nov 18 2016,New Orleans Pelicans,113,Portland Trail Blazers,101,12
1030,181,Fri Nov 18 2016,Oklahoma City Thunder,124,Brooklyn Nets,105,19
181,181,Fri Nov 18 2016,Brooklyn Nets,105,Oklahoma City Thunder,124,-19
182,182,Fri Nov 18 2016,Los Angeles Clippers,121,Sacramento Kings,115,6
1031,182,Fri Nov 18 2016,Sacramento Kings,115,Los Angeles Clippers,121,-6
1032,183,Sat Nov 19 2016,Detroit Pistons,92,Boston Celtics,94,-2
183,183,Sat Nov 19 2016,Boston Celtics,94,Detroit Pistons,92,2
1033,184,Sat Nov 19 2016,Houston Rockets,111,Utah Jazz,102,9
184,184,Sat Nov 19 2016,Utah Jazz,102,Houston Rockets,111,-9
185,185,Sat Nov 19 2016,Chicago Bulls,95,Los Angeles Clippers,102,-7
1034,185,Sat Nov 19 2016,Los Angeles Clippers,102,Chicago Bulls,95,7
186,186,Sat Nov 19 2016,Minnesota Timberwolves,71,Memphis Grizzlies,93,-22
1035,186,Sat Nov 19 2016,Memphis Grizzlies,93,Minnesota Timberwolves,71,22
187,187,Sat Nov 19 2016,Golden State Warriors,124,Milwaukee Bucks,121,3
1036,187,Sat Nov 19 2016,Milwaukee Bucks,121,Golden State Warriors,124,-3
188,188,Sat Nov 19 2016,Charlotte Hornets,116,New Orleans Pelicans,121,-5
1037,188,Sat Nov 19 2016,New Orleans Pelicans,121,Charlotte Hornets,116,5
189,189,Sat Nov 19 2016,Dallas Mavericks,87,Orlando Magic,95,-8
1038,189,Sat Nov 19 2016,Orlando Magic,95,Dallas Mavericks,87,8
1039,190,Sat Nov 19 2016,Philadelphia 76ers,120,Phoenix Suns,105,15
190,190,Sat Nov 19 2016,Phoenix Suns,105,Philadelphia 76ers,120,-15
1040,191,Sat Nov 19 2016,Washington Wizards,111,Miami Heat,114,-3
191,191,Sat Nov 19 2016,Miami Heat,114,Washington Wizards,111,3
192,192,Sun Nov 20 2016,Portland Trail Blazers,129,Brooklyn Nets,109,20
1041,192,Sun Nov 20 2016,Brooklyn Nets,109,Portland Trail Blazers,129,-20
1042,193,Sun Nov 20 2016,Denver Nuggets,105,Utah Jazz,91,14
193,193,Sun Nov 20 2016,Utah Jazz,91,Denver Nuggets,105,-14
1043,194,Sun Nov 20 2016,Los Angeles Lakers,110,Chicago Bulls,118,-8
194,194,Sun Nov 20 2016,Chicago Bulls,118,Los Angeles Lakers,110,8
1044,195,Sun Nov 20 2016,New York Knicks,104,Atlanta Hawks,94,10
195,195,Sun Nov 20 2016,Atlanta Hawks,94,New York Knicks,104,-10
196,196,Sun Nov 20 2016,Indiana Pacers,115,Oklahoma City Thunder,111,4
1045,196,Sun Nov 20 2016,Oklahoma City Thunder,111,Indiana Pacers,115,-4
197,197,Sun Nov 20 2016,Toronto Raptors,99,Sacramento Kings,102,-3
1046,197,Sun Nov 20 2016,Sacramento Kings,102,Toronto Raptors,99,3
198,198,Mon Nov 21 2016,Memphis Grizzlies,105,Charlotte Hornets,90,15
1047,198,Mon Nov 21 2016,Charlotte Hornets,90,Memphis Grizzlies,105,-15
199,199,Mon Nov 21 2016,Houston Rockets,99,Detroit Pistons,96,3
1048,199,Mon Nov 21 2016,Detroit Pistons,96,Houston Rockets,99,-3
200,200,Mon Nov 21 2016,Golden State Warriors,120,Indiana Pacers,83,37
1049,200,Mon Nov 21 2016,Indiana Pacers,83,Golden State Warriors,120,-37
201,201,Mon Nov 21 2016,Toronto Raptors,115,Los Angeles Clippers,123,-8
1050,201,Mon Nov 21 2016,Los Angeles Clippers,123,Toronto Raptors,115,8
202,202,Mon Nov 21 2016,Orlando Magic,89,Milwaukee Bucks,93,-4
1051,202,Mon Nov 21 2016,Milwaukee Bucks,93,Orlando Magic,89,4
203,203,Mon Nov 21 2016,Boston Celtics,99,Minnesota Timberwolves,93,6
1052,203,Mon Nov 21 2016,Minnesota Timberwolves,93,Boston Celtics,99,-6
204,204,Mon Nov 21 2016,Miami Heat,94,Philadelphia 76ers,101,-7
1053,204,Mon Nov 21 2016,Philadelphia 76ers,101,Miami Heat,94,7
1054,205,Mon Nov 21 2016,San Antonio Spurs,96,Dallas Mavericks,91,5
205,205,Mon Nov 21 2016,Dallas Mavericks,91,San Antonio Spurs,96,-5
1055,206,Mon Nov 21 2016,Washington Wizards,106,Phoenix Suns,101,5
206,206,Mon Nov 21 2016,Phoenix Suns,101,Washington Wizards,106,-5
207,207,Tue Nov 22 2016,New Orleans Pelicans,112,Atlanta Hawks,94,18
1056,207,Tue Nov 22 2016,Atlanta Hawks,94,New Orleans Pelicans,112,-18
208,208,Tue Nov 22 2016,Chicago Bulls,107,Denver Nuggets,110,-3
1057,208,Tue Nov 22 2016,Denver Nuggets,110,Chicago Bulls,107,3
1058,209,Tue Nov 22 2016,Los Angeles Lakers,111,Oklahoma City Thunder,109,2
209,209,Tue Nov 22 2016,Oklahoma City Thunder,109,Los Angeles Lakers,111,-2
1059,210,Tue Nov 22 2016,New York Knicks,107,Portland Trail Blazers,103,4
210,210,Tue Nov 22 2016,Portland Trail Blazers,103,New York Knicks,107,-4
211,211,Wed Nov 23 2016,Boston Celtics,111,Brooklyn Nets,92,19
1060,211,Wed Nov 23 2016,Brooklyn Nets,92,Boston Celtics,111,-19
1061,212,Wed Nov 23 2016,Charlotte Hornets,114,San Antonio Spurs,119,-5
212,212,Wed Nov 23 2016,San Antonio Spurs,119,Charlotte Hornets,114,5
213,213,Wed Nov 23 2016,Portland Trail Blazers,125,Cleveland Cavaliers,137,-12
1062,213,Wed Nov 23 2016,Cleveland Cavaliers,137,Portland Trail Blazers,125,12
214,214,Wed Nov 23 2016,Los Angeles Clippers,124,Dallas Mavericks,104,20
1063,214,Wed Nov 23 2016,Dallas Mavericks,104,Los Angeles Clippers,124,-20
1064,215,Wed Nov 23 2016,Detroit Pistons,107,Miami Heat,84,23
215,215,Wed Nov 23 2016,Miami Heat,84,Detroit Pistons,107,-23
1065,216,Wed Nov 23 2016,Golden State Warriors,149,Los Angeles Lakers,106,43
216,216,Wed Nov 23 2016,Los Angeles Lakers,106,Golden State Warriors,149,-43
217,217,Wed Nov 23 2016,Toronto Raptors,115,Houston Rockets,102,13
1066,217,Wed Nov 23 2016,Houston Rockets,102,Toronto Raptors,115,-13
218,218,Wed Nov 23 2016,Atlanta Hawks,96,Indiana Pacers,85,11
1067,218,Wed Nov 23 2016,Indiana Pacers,85,Atlanta Hawks,96,-11
1068,219,Wed Nov 23 2016,New Orleans Pelicans,117,Minnesota Timberwolves,96,21
219,219,Wed Nov 23 2016,Minnesota Timberwolves,96,New Orleans Pelicans,117,-21
220,220,Wed Nov 23 2016,Phoenix Suns,92,Orlando Magic,87,5
1069,220,Wed Nov 23 2016,Orlando Magic,87,Phoenix Suns,92,-5
1070,221,Wed Nov 23 2016,Philadelphia 76ers,99,Memphis Grizzlies,104,-5
221,221,Wed Nov 23 2016,Memphis Grizzlies,104,Philadelphia 76ers,99,5
1071,222,Wed Nov 23 2016,Sacramento Kings,116,Oklahoma City Thunder,101,15
222,222,Wed Nov 23 2016,Oklahoma City Thunder,101,Sacramento Kings,116,-15
1072,223,Wed Nov 23 2016,Utah Jazz,108,Denver Nuggets,83,25
223,223,Wed Nov 23 2016,Denver Nuggets,83,Utah Jazz,108,-25
224,224,Fri Nov 25 2016,San Antonio Spurs,109,Boston Celtics,103,6
1073,224,Fri Nov 25 2016,Boston Celtics,103,San Antonio Spurs,109,-6
225,225,Fri Nov 25 2016,Dallas Mavericks,90,Cleveland Cavaliers,128,-38
1074,225,Fri Nov 25 2016,Cleveland Cavaliers,128,Dallas Mavericks,90,38
226,226,Fri Nov 25 2016,Oklahoma City Thunder,132,Denver Nuggets,129,3
1075,226,Fri Nov 25 2016,Denver Nuggets,129,Oklahoma City Thunder,132,-3
1076,227,Fri Nov 25 2016,Detroit Pistons,108,Los Angeles Clippers,97,11
227,227,Fri Nov 25 2016,Los Angeles Clippers,97,Detroit Pistons,108,-11
228,228,Fri Nov 25 2016,Brooklyn Nets,97,Indiana Pacers,118,-21
1077,228,Fri Nov 25 2016,Indiana Pacers,118,Brooklyn Nets,97,21
1078,229,Fri Nov 25 2016,Los Angeles Lakers,85,Golden State Warriors,109,-24
229,229,Fri Nov 25 2016,Golden State Warriors,109,Los Angeles Lakers,85,24
230,230,Fri Nov 25 2016,Miami Heat,90,Memphis Grizzlies,81,9
1079,230,Fri Nov 25 2016,Memphis Grizzlies,81,Miami Heat,90,-9
1080,231,Fri Nov 25 2016,Milwaukee Bucks,99,Toronto Raptors,105,-6
231,231,Fri Nov 25 2016,Toronto Raptors,105,Milwaukee Bucks,99,6
1081,232,Fri Nov 25 2016,New York Knicks,113,Charlotte Hornets,111,2
232,232,Fri Nov 25 2016,Charlotte Hornets,111,New York Knicks,113,-2
1082,233,Fri Nov 25 2016,Orlando Magic,91,Washington Wizards,94,-3
233,233,Fri Nov 25 2016,Washington Wizards,94,Orlando Magic,91,3
234,234,Fri Nov 25 2016,Chicago Bulls,105,Philadelphia 76ers,89,16
1083,234,Fri Nov 25 2016,Philadelphia 76ers,89,Chicago Bulls,105,-16
235,235,Fri Nov 25 2016,Minnesota Timberwolves,98,Phoenix Suns,85,13
1084,235,Fri Nov 25 2016,Phoenix Suns,85,Minnesota Timberwolves,98,-13
236,236,Fri Nov 25 2016,New Orleans Pelicans,104,Portland Trail Blazers,119,-15
1085,236,Fri Nov 25 2016,Portland Trail Blazers,119,New Orleans Pelicans,104,15
237,237,Fri Nov 25 2016,Houston Rockets,117,Sacramento Kings,104,13
1086,237,Fri Nov 25 2016,Sacramento Kings,104,Houston Rockets,117,-13
238,238,Fri Nov 25 2016,Atlanta Hawks,68,Utah Jazz,95,-27
1087,238,Fri Nov 25 2016,Utah Jazz,95,Atlanta Hawks,68,27
239,239,Sat Nov 26 2016,New York Knicks,102,Charlotte Hornets,107,-5
1088,239,Sat Nov 26 2016,Charlotte Hornets,107,New York Knicks,102,5
240,240,Sat Nov 26 2016,Minnesota Timberwolves,102,Golden State Warriors,115,-13
1089,240,Sat Nov 26 2016,Golden State Warriors,115,Minnesota Timberwolves,102,13
241,241,Sat Nov 26 2016,Memphis Grizzlies,110,Miami Heat,107,3
1090,241,Sat Nov 26 2016,Miami Heat,107,Memphis Grizzlies,110,-3
242,242,Sat Nov 26 2016,Detroit Pistons,88,Oklahoma City Thunder,106,-18
1091,242,Sat Nov 26 2016,Oklahoma City Thunder,106,Detroit Pistons,88,18
243,243,Sat Nov 26 2016,San Antonio Spurs,112,Washington Wizards,100,12
1092,243,Sat Nov 26 2016,Washington Wizards,100,San Antonio Spurs,112,-12
1093,244,Sun Nov 27 2016,Brooklyn Nets,105,Sacramento Kings,122,-17
244,244,Sun Nov 27 2016,Sacramento Kings,122,Brooklyn Nets,105,17
245,245,Sun Nov 27 2016,New Orleans Pelicans,81,Dallas Mavericks,91,-10
1094,245,Sun Nov 27 2016,Dallas Mavericks,91,New Orleans Pelicans,81,10
246,246,Sun Nov 27 2016,Los Angeles Clippers,70,Indiana Pacers,91,-21
1095,246,Sun Nov 27 2016,Indiana Pacers,91,Los Angeles Clippers,70,21
247,247,Sun Nov 27 2016,Atlanta Hawks,94,Los Angeles Lakers,109,-15
1096,247,Sun Nov 27 2016,Los Angeles Lakers,109,Atlanta Hawks,94,15
248,248,Sun Nov 27 2016,Milwaukee Bucks,104,Orlando Magic,96,8
1097,248,Sun Nov 27 2016,Orlando Magic,96,Milwaukee Bucks,104,-8
249,249,Sun Nov 27 2016,Cleveland Cavaliers,112,Philadelphia 76ers,108,4
1098,249,Sun Nov 27 2016,Philadelphia 76ers,108,Cleveland Cavaliers,112,-4
250,250,Sun Nov 27 2016,Denver Nuggets,120,Phoenix Suns,114,6
1099,250,Sun Nov 27 2016,Phoenix Suns,114,Denver Nuggets,120,-6
251,251,Sun Nov 27 2016,Houston Rockets,130,Portland Trail Blazers,114,16
1100,251,Sun Nov 27 2016,Portland Trail Blazers,114,Houston Rockets,130,-16
1101,252,Mon Nov 28 2016,Golden State Warriors,105,Atlanta Hawks,100,5
252,252,Mon Nov 28 2016,Atlanta Hawks,100,Golden State Warriors,105,-5
1102,253,Mon Nov 28 2016,Memphis Grizzlies,85,Charlotte Hornets,104,-19
253,253,Mon Nov 28 2016,Charlotte Hornets,104,Memphis Grizzlies,85,19
254,254,Mon Nov 28 2016,Boston Celtics,112,Miami Heat,104,8
1103,254,Mon Nov 28 2016,Miami Heat,104,Boston Celtics,112,-8
255,255,Mon Nov 28 2016,Utah Jazz,112,Minnesota Timberwolves,103,9
1104,255,Mon Nov 28 2016,Minnesota Timberwolves,103,Utah Jazz,112,-9
256,256,Mon Nov 28 2016,Oklahoma City Thunder,112,New York Knicks,103,9
1105,256,Mon Nov 28 2016,New York Knicks,103,Oklahoma City Thunder,112,-9
257,257,Mon Nov 28 2016,Philadelphia 76ers,95,Toronto Raptors,122,-27
1106,257,Mon Nov 28 2016,Toronto Raptors,122,Philadelphia 76ers,95,27
258,258,Mon Nov 28 2016,Sacramento Kings,95,Washington Wizards,101,-6
1107,258,Mon Nov 28 2016,Washington Wizards,101,Sacramento Kings,95,6
259,259,Tue Nov 29 2016,Los Angeles Clippers,122,Brooklyn Nets,127,-5
1108,259,Tue Nov 29 2016,Brooklyn Nets,127,Los Angeles Clippers,122,5
1109,260,Tue Nov 29 2016,Charlotte Hornets,89,Detroit Pistons,112,-23
260,260,Tue Nov 29 2016,Detroit Pistons,112,Charlotte Hornets,89,23
261,261,Tue Nov 29 2016,Cleveland Cavaliers,101,Milwaukee Bucks,118,-17
1110,261,Tue Nov 29 2016,Milwaukee Bucks,118,Cleveland Cavaliers,101,17
1111,262,Tue Nov 29 2016,New Orleans Pelicans,105,Los Angeles Lakers,88,17
262,262,Tue Nov 29 2016,Los Angeles Lakers,88,New Orleans Pelicans,105,-17
1112,263,Tue Nov 29 2016,San Antonio Spurs,83,Orlando Magic,95,-12
263,263,Tue Nov 29 2016,Orlando Magic,95,San Antonio Spurs,83,12
1113,264,Tue Nov 29 2016,Utah Jazz,120,Houston Rockets,101,19
264,264,Tue Nov 29 2016,Houston Rockets,101,Utah Jazz,120,-19
1114,265,Wed Nov 30 2016,Boston Celtics,114,Detroit Pistons,121,-7
265,265,Wed Nov 30 2016,Detroit Pistons,121,Boston Celtics,114,7
1115,266,Wed Nov 30 2016,Chicago Bulls,90,Los Angeles Lakers,96,-6
266,266,Wed Nov 30 2016,Los Angeles Lakers,96,Chicago Bulls,90,6
1116,267,Wed Nov 30 2016,Dallas Mavericks,87,San Antonio Spurs,94,-7
267,267,Wed Nov 30 2016,San Antonio Spurs,94,Dallas Mavericks,87,7
268,268,Wed Nov 30 2016,Miami Heat,106,Denver Nuggets,98,8
1117,268,Wed Nov 30 2016,Denver Nuggets,98,Miami Heat,106,-8
269,269,Wed Nov 30 2016,New York Knicks,106,Minnesota Timberwolves,104,2
1118,269,Wed Nov 30 2016,Minnesota Timberwolves,104,New York Knicks,106,-2
270,270,Wed Nov 30 2016,Washington Wizards,115,Oklahoma City Thunder,126,-11
1119,270,Wed Nov 30 2016,Oklahoma City Thunder,126,Washington Wizards,115,11
1120,271,Wed Nov 30 2016,Phoenix Suns,109,Atlanta Hawks,107,2
271,271,Wed Nov 30 2016,Atlanta Hawks,107,Phoenix Suns,109,-2
1121,272,Wed Nov 30 2016,Portland Trail Blazers,131,Indiana Pacers,109,22
272,272,Wed Nov 30 2016,Indiana Pacers,109,Portland Trail Blazers,131,-22
1122,273,Wed Nov 30 2016,Toronto Raptors,120,Memphis Grizzlies,105,15
273,273,Wed Nov 30 2016,Memphis Grizzlies,105,Toronto Raptors,120,-15
1123,274,Thu Dec 1 2016,Brooklyn Nets,93,Milwaukee Bucks,111,-18
274,274,Thu Dec 1 2016,Milwaukee Bucks,111,Brooklyn Nets,93,18
1124,275,Thu Dec 1 2016,Charlotte Hornets,97,Dallas Mavericks,87,10
275,275,Thu Dec 1 2016,Dallas Mavericks,87,Charlotte Hornets,97,-10
1125,276,Thu Dec 1 2016,Cleveland Cavaliers,94,Los Angeles Clippers,113,-19
276,276,Thu Dec 1 2016,Los Angeles Clippers,113,Cleveland Cavaliers,94,19
1126,277,Thu Dec 1 2016,Golden State Warriors,127,Houston Rockets,132,-5
277,277,Thu Dec 1 2016,Houston Rockets,132,Golden State Warriors,127,5
278,278,Thu Dec 1 2016,Orlando Magic,94,Memphis Grizzlies,95,-1
1127,278,Thu Dec 1 2016,Memphis Grizzlies,95,Orlando Magic,94,1
1128,279,Thu Dec 1 2016,Utah Jazz,110,Miami Heat,111,-1
279,279,Thu Dec 1 2016,Miami Heat,111,Utah Jazz,110,1
280,280,Fri Dec 2 2016,Detroit Pistons,121,Atlanta Hawks,85,36
1129,280,Fri Dec 2 2016,Atlanta Hawks,85,Detroit Pistons,121,-36
1130,281,Fri Dec 2 2016,Boston Celtics,97,Sacramento Kings,92,5
281,281,Fri Dec 2 2016,Sacramento Kings,92,Boston Celtics,97,-5
1131,282,Fri Dec 2 2016,Chicago Bulls,111,Cleveland Cavaliers,105,6
282,282,Fri Dec 2 2016,Cleveland Cavaliers,105,Chicago Bulls,111,-6
283,283,Fri Dec 2 2016,Houston Rockets,128,Denver Nuggets,110,18
1132,283,Fri Dec 2 2016,Denver Nuggets,110,Houston Rockets,128,-18
284,284,Fri Dec 2 2016,Los Angeles Clippers,114,New Orleans Pelicans,96,18
1133,284,Fri Dec 2 2016,New Orleans Pelicans,96,Los Angeles Clippers,114,-18
285,285,Fri Dec 2 2016,Minnesota Timberwolves,114,New York Knicks,118,-4
1134,285,Fri Dec 2 2016,New York Knicks,118,Minnesota Timberwolves,114,4
286,286,Fri Dec 2 2016,Orlando Magic,105,Philadelphia 76ers,88,17
1135,286,Fri Dec 2 2016,Philadelphia 76ers,88,Orlando Magic,105,-17
1136,287,Fri Dec 2 2016,San Antonio Spurs,107,Washington Wizards,105,2
287,287,Fri Dec 2 2016,Washington Wizards,105,San Antonio Spurs,107,-2
1137,288,Fri Dec 2 2016,Toronto Raptors,113,Los Angeles Lakers,80,33
288,288,Fri Dec 2 2016,Los Angeles Lakers,80,Toronto Raptors,113,-33
1138,289,Sat Dec 3 2016,Charlotte Hornets,120,Minnesota Timberwolves,125,-5
289,289,Sat Dec 3 2016,Minnesota Timberwolves,125,Charlotte Hornets,120,5
1139,290,Sat Dec 3 2016,Dallas Mavericks,107,Chicago Bulls,82,25
290,290,Sat Dec 3 2016,Chicago Bulls,82,Dallas Mavericks,107,-25
1140,291,Sat Dec 3 2016,Golden State Warriors,138,Phoenix Suns,109,29
291,291,Sat Dec 3 2016,Phoenix Suns,109,Golden State Warriors,138,-29
292,292,Sat Dec 3 2016,Los Angeles Lakers,100,Memphis Grizzlies,103,-3
1141,292,Sat Dec 3 2016,Memphis Grizzlies,103,Los Angeles Lakers,100,3
1142,293,Sat Dec 3 2016,Milwaukee Bucks,112,Brooklyn Nets,103,9
293,293,Sat Dec 3 2016,Brooklyn Nets,103,Milwaukee Bucks,112,-9
1143,294,Sat Dec 3 2016,Philadelphia 76ers,106,Boston Celtics,107,-1
294,294,Sat Dec 3 2016,Boston Celtics,107,Philadelphia 76ers,106,1
1144,295,Sat Dec 3 2016,Portland Trail Blazers,99,Miami Heat,92,7
295,295,Sat Dec 3 2016,Miami Heat,92,Portland Trail Blazers,99,-7
1145,296,Sat Dec 3 2016,Toronto Raptors,128,Atlanta Hawks,84,44
296,296,Sat Dec 3 2016,Atlanta Hawks,84,Toronto Raptors,128,-44
1146,297,Sat Dec 3 2016,Utah Jazz,105,Denver Nuggets,98,7
297,297,Sat Dec 3 2016,Denver Nuggets,98,Utah Jazz,105,-7
298,298,Sun Dec 4 2016,Orlando Magic,98,Detroit Pistons,92,6
1147,298,Sun Dec 4 2016,Detroit Pistons,92,Orlando Magic,98,-6
299,299,Sun Dec 4 2016,Indiana Pacers,111,Los Angeles Clippers,102,9
1148,299,Sun Dec 4 2016,Los Angeles Clippers,102,Indiana Pacers,111,-9
300,300,Sun Dec 4 2016,Sacramento Kings,98,New York Knicks,106,-8
1149,300,Sun Dec 4 2016,New York Knicks,106,Sacramento Kings,98,8
1150,301,Sun Dec 4 2016,Oklahoma City Thunder,101,New Orleans Pelicans,92,9
301,301,Sun Dec 4 2016,New Orleans Pelicans,92,Oklahoma City Thunder,101,-9
302,302,Mon Dec 5 2016,Oklahoma City Thunder,102,Atlanta Hawks,99,3
1151,302,Mon Dec 5 2016,Atlanta Hawks,99,Oklahoma City Thunder,102,-3
1152,303,Mon Dec 5 2016,Brooklyn Nets,113,Washington Wizards,118,-5
303,303,Mon Dec 5 2016,Washington Wizards,118,Brooklyn Nets,113,5
1153,304,Mon Dec 5 2016,Chicago Bulls,110,Portland Trail Blazers,112,-2
304,304,Mon Dec 5 2016,Portland Trail Blazers,112,Chicago Bulls,110,2
305,305,Mon Dec 5 2016,Charlotte Hornets,109,Dallas Mavericks,101,8
1154,305,Mon Dec 5 2016,Dallas Mavericks,101,Charlotte Hornets,109,-8
306,306,Mon Dec 5 2016,Indiana Pacers,106,Golden State Warriors,142,-36
1155,306,Mon Dec 5 2016,Golden State Warriors,142,Indiana Pacers,106,36
307,307,Mon Dec 5 2016,Boston Celtics,106,Houston Rockets,107,-1
1156,307,Mon Dec 5 2016,Houston Rockets,107,Boston Celtics,106,1
1157,308,Mon Dec 5 2016,Los Angeles Lakers,101,Utah Jazz,107,-6
308,308,Mon Dec 5 2016,Utah Jazz,107,Los Angeles Lakers,101,6
1158,309,Mon Dec 5 2016,Milwaukee Bucks,96,San Antonio Spurs,97,-1
309,309,Mon Dec 5 2016,San Antonio Spurs,97,Milwaukee Bucks,96,1
310,310,Mon Dec 5 2016,Memphis Grizzlies,110,New Orleans Pelicans,108,2
1159,310,Mon Dec 5 2016,New Orleans Pelicans,108,Memphis Grizzlies,110,-2
1160,311,Mon Dec 5 2016,Philadelphia 76ers,98,Denver Nuggets,106,-8
311,311,Mon Dec 5 2016,Denver Nuggets,106,Philadelphia 76ers,98,8
312,312,Mon Dec 5 2016,Cleveland Cavaliers,116,Toronto Raptors,112,4
1161,312,Mon Dec 5 2016,Toronto Raptors,112,Cleveland Cavaliers,116,-4
313,313,Tue Dec 6 2016,Chicago Bulls,91,Detroit Pistons,102,-11
1162,313,Tue Dec 6 2016,Detroit Pistons,102,Chicago Bulls,91,11
314,314,Tue Dec 6 2016,Philadelphia 76ers,91,Memphis Grizzlies,96,-5
1163,314,Tue Dec 6 2016,Memphis Grizzlies,96,Philadelphia 76ers,91,5
315,315,Tue Dec 6 2016,New York Knicks,114,Miami Heat,103,11
1164,315,Tue Dec 6 2016,Miami Heat,103,New York Knicks,114,-11
1165,316,Tue Dec 6 2016,Minnesota Timberwolves,91,San Antonio Spurs,105,-14
316,316,Tue Dec 6 2016,San Antonio Spurs,105,Minnesota Timberwolves,91,14
317,317,Tue Dec 6 2016,Phoenix Suns,105,Utah Jazz,112,-7
1166,317,Tue Dec 6 2016,Utah Jazz,112,Phoenix Suns,105,7
318,318,Tue Dec 6 2016,Orlando Magic,124,Washington Wizards,116,8
1167,318,Tue Dec 6 2016,Washington Wizards,116,Orlando Magic,124,-8
319,319,Wed Dec 7 2016,Miami Heat,95,Atlanta Hawks,103,-8
1168,319,Wed Dec 7 2016,Atlanta Hawks,103,Miami Heat,95,8
320,320,Wed Dec 7 2016,Denver Nuggets,111,Brooklyn Nets,116,-5
1169,320,Wed Dec 7 2016,Brooklyn Nets,116,Denver Nuggets,111,5
321,321,Wed Dec 7 2016,Detroit Pistons,77,Charlotte Hornets,87,-10
1170,321,Wed Dec 7 2016,Charlotte Hornets,87,Detroit Pistons,77,10
1171,322,Wed Dec 7 2016,Dallas Mavericks,89,Sacramento Kings,120,-31
322,322,Wed Dec 7 2016,Sacramento Kings,120,Dallas Mavericks,89,31
1172,323,Wed Dec 7 2016,Houston Rockets,134,Los Angeles Lakers,95,39
323,323,Wed Dec 7 2016,Los Angeles Lakers,95,Houston Rockets,134,-39
1173,324,Wed Dec 7 2016,Los Angeles Clippers,98,Golden State Warriors,115,-17
324,324,Wed Dec 7 2016,Golden State Warriors,115,Los Angeles Clippers,98,17
325,325,Wed Dec 7 2016,Portland Trail Blazers,107,Milwaukee Bucks,115,-8
1174,325,Wed Dec 7 2016,Milwaukee Bucks,115,Portland Trail Blazers,107,8
326,326,Wed Dec 7 2016,Cleveland Cavaliers,126,New York Knicks,94,32
1175,326,Wed Dec 7 2016,New York Knicks,94,Cleveland Cavaliers,126,-32
327,327,Wed Dec 7 2016,Boston Celtics,117,Orlando Magic,87,30
1176,327,Wed Dec 7 2016,Orlando Magic,87,Boston Celtics,117,-30
1177,328,Wed Dec 7 2016,Phoenix Suns,94,Indiana Pacers,109,-15
328,328,Wed Dec 7 2016,Indiana Pacers,109,Phoenix Suns,94,15
329,329,Thu Dec 8 2016,San Antonio Spurs,91,Chicago Bulls,95,-4
1178,329,Thu Dec 8 2016,Chicago Bulls,95,San Antonio Spurs,91,4
1179,330,Thu Dec 8 2016,Memphis Grizzlies,88,Portland Trail Blazers,86,2
330,330,Thu Dec 8 2016,Portland Trail Blazers,86,Memphis Grizzlies,88,-2
1180,331,Thu Dec 8 2016,New Orleans Pelicans,88,Philadelphia 76ers,99,-11
331,331,Thu Dec 8 2016,Philadelphia 76ers,99,New Orleans Pelicans,88,11
1181,332,Thu Dec 8 2016,Toronto Raptors,124,Minnesota Timberwolves,110,14
332,332,Thu Dec 8 2016,Minnesota Timberwolves,110,Toronto Raptors,124,-14
1182,333,Thu Dec 8 2016,Utah Jazz,99,Golden State Warriors,106,-7
333,333,Thu Dec 8 2016,Golden State Warriors,106,Utah Jazz,99,7
334,334,Thu Dec 8 2016,Denver Nuggets,85,Washington Wizards,92,-7
1183,334,Thu Dec 8 2016,Washington Wizards,92,Denver Nuggets,85,7
1184,335,Fri Dec 9 2016,Boston Celtics,94,Toronto Raptors,101,-7
335,335,Fri Dec 9 2016,Toronto Raptors,101,Boston Celtics,94,7
1185,336,Fri Dec 9 2016,Charlotte Hornets,109,Orlando Magic,88,21
336,336,Fri Dec 9 2016,Orlando Magic,88,Charlotte Hornets,109,-21
1186,337,Fri Dec 9 2016,Cleveland Cavaliers,114,Miami Heat,84,30
337,337,Fri Dec 9 2016,Miami Heat,84,Cleveland Cavaliers,114,-30
1187,338,Fri Dec 9 2016,Dallas Mavericks,111,Indiana Pacers,103,8
338,338,Fri Dec 9 2016,Indiana Pacers,103,Dallas Mavericks,111,-8
339,339,Fri Dec 9 2016,Phoenix Suns,119,Los Angeles Lakers,115,4
1188,339,Fri Dec 9 2016,Los Angeles Lakers,115,Phoenix Suns,119,-4
340,340,Fri Dec 9 2016,Atlanta Hawks,114,Milwaukee Bucks,110,4
1189,340,Fri Dec 9 2016,Milwaukee Bucks,110,Atlanta Hawks,114,-4
341,341,Fri Dec 9 2016,Detroit Pistons,117,Minnesota Timberwolves,90,27
1190,341,Fri Dec 9 2016,Minnesota Timberwolves,90,Detroit Pistons,117,-27
1191,342,Fri Dec 9 2016,Oklahoma City Thunder,99,Houston Rockets,102,-3
342,342,Fri Dec 9 2016,Houston Rockets,102,Oklahoma City Thunder,99,3
343,343,Fri Dec 9 2016,New York Knicks,103,Sacramento Kings,100,3
1192,343,Fri Dec 9 2016,Sacramento Kings,100,New York Knicks,103,-3
1193,344,Sat Dec 10 2016,Chicago Bulls,105,Miami Heat,100,5
344,344,Sat Dec 10 2016,Miami Heat,100,Chicago Bulls,105,-5
345,345,Sat Dec 10 2016,Charlotte Hornets,105,Cleveland Cavaliers,116,-11
1194,345,Sat Dec 10 2016,Cleveland Cavaliers,116,Charlotte Hornets,105,11
1195,346,Sat Dec 10 2016,Houston Rockets,109,Dallas Mavericks,87,22
346,346,Sat Dec 10 2016,Dallas Mavericks,87,Houston Rockets,109,-22
1196,347,Sat Dec 10 2016,Indiana Pacers,118,Portland Trail Blazers,111,7
347,347,Sat Dec 10 2016,Portland Trail Blazers,111,Indiana Pacers,118,-7
348,348,Sat Dec 10 2016,New Orleans Pelicans,105,Los Angeles Clippers,133,-28
1197,348,Sat Dec 10 2016,Los Angeles Clippers,133,New Orleans Pelicans,105,28
349,349,Sat Dec 10 2016,Golden State Warriors,89,Memphis Grizzlies,110,-21
1198,349,Sat Dec 10 2016,Memphis Grizzlies,110,Golden State Warriors,89,21
350,350,Sat Dec 10 2016,Denver Nuggets,121,Orlando Magic,113,8
1199,350,Sat Dec 10 2016,Orlando Magic,113,Denver Nuggets,121,-8
1200,351,Sat Dec 10 2016,San Antonio Spurs,130,Brooklyn Nets,101,29
351,351,Sat Dec 10 2016,Brooklyn Nets,101,San Antonio Spurs,130,-29
1201,352,Sat Dec 10 2016,Utah Jazz,104,Sacramento Kings,84,20
352,352,Sat Dec 10 2016,Sacramento Kings,84,Utah Jazz,104,-20
1202,353,Sat Dec 10 2016,Washington Wizards,110,Milwaukee Bucks,105,5
353,353,Sat Dec 10 2016,Milwaukee Bucks,105,Washington Wizards,110,-5
1203,354,Sun Dec 11 2016,Detroit Pistons,79,Philadelphia 76ers,97,-18
354,354,Sun Dec 11 2016,Philadelphia 76ers,97,Detroit Pistons,79,18
1204,355,Sun Dec 11 2016,Los Angeles Lakers,112,New York Knicks,118,-6
355,355,Sun Dec 11 2016,New York Knicks,118,Los Angeles Lakers,112,6
356,356,Sun Dec 11 2016,Golden State Warriors,116,Minnesota Timberwolves,108,8
1205,356,Sun Dec 11 2016,Minnesota Timberwolves,108,Golden State Warriors,116,-8
1206,357,Sun Dec 11 2016,Oklahoma City Thunder,99,Boston Celtics,96,3
357,357,Sun Dec 11 2016,Boston Celtics,96,Oklahoma City Thunder,99,-3
1207,358,Sun Dec 11 2016,Phoenix Suns,119,New Orleans Pelicans,120,-1
358,358,Sun Dec 11 2016,New Orleans Pelicans,120,Phoenix Suns,119,1
1208,359,Mon Dec 12 2016,Dallas Mavericks,112,Denver Nuggets,92,20
359,359,Mon Dec 12 2016,Denver Nuggets,92,Dallas Mavericks,112,-20
360,360,Mon Dec 12 2016,Brooklyn Nets,118,Houston Rockets,122,-4
1209,360,Mon Dec 12 2016,Houston Rockets,122,Brooklyn Nets,118,4
1210,361,Mon Dec 12 2016,Indiana Pacers,110,Charlotte Hornets,94,16
361,361,Mon Dec 12 2016,Charlotte Hornets,94,Indiana Pacers,110,-16
1211,362,Mon Dec 12 2016,Los Angeles Clippers,121,Portland Trail Blazers,120,1
362,362,Mon Dec 12 2016,Portland Trail Blazers,120,Los Angeles Clippers,121,-1
1212,363,Mon Dec 12 2016,Miami Heat,112,Washington Wizards,101,11
363,363,Mon Dec 12 2016,Washington Wizards,101,Miami Heat,112,-11
1213,364,Mon Dec 12 2016,Sacramento Kings,116,Los Angeles Lakers,92,24
364,364,Mon Dec 12 2016,Los Angeles Lakers,92,Sacramento Kings,116,-24
1214,365,Mon Dec 12 2016,Toronto Raptors,122,Milwaukee Bucks,100,22
365,365,Mon Dec 12 2016,Milwaukee Bucks,100,Toronto Raptors,122,-22
1215,366,Tue Dec 13 2016,Atlanta Hawks,120,Orlando Magic,131,-11
366,366,Tue Dec 13 2016,Orlando Magic,131,Atlanta Hawks,120,11
367,367,Tue Dec 13 2016,Minnesota Timberwolves,99,Chicago Bulls,94,5
1216,367,Tue Dec 13 2016,Chicago Bulls,94,Minnesota Timberwolves,99,-5
368,368,Tue Dec 13 2016,Memphis Grizzlies,86,Cleveland Cavaliers,103,-17
1217,368,Tue Dec 13 2016,Cleveland Cavaliers,103,Memphis Grizzlies,86,17
369,369,Tue Dec 13 2016,Golden State Warriors,113,New Orleans Pelicans,109,4
1218,369,Tue Dec 13 2016,New Orleans Pelicans,109,Golden State Warriors,113,-4
1219,370,Tue Dec 13 2016,Phoenix Suns,113,New York Knicks,111,2
370,370,Tue Dec 13 2016,New York Knicks,111,Phoenix Suns,113,-2
371,371,Tue Dec 13 2016,Oklahoma City Thunder,95,Portland Trail Blazers,114,-19
1220,371,Tue Dec 13 2016,Portland Trail Blazers,114,Oklahoma City Thunder,95,19
372,372,Wed Dec 14 2016,Los Angeles Lakers,97,Brooklyn Nets,107,-10
1221,372,Wed Dec 14 2016,Brooklyn Nets,107,Los Angeles Lakers,97,10
373,373,Wed Dec 14 2016,Detroit Pistons,95,Dallas Mavericks,85,10
1222,373,Wed Dec 14 2016,Dallas Mavericks,85,Detroit Pistons,95,-10
1223,374,Wed Dec 14 2016,Houston Rockets,132,Sacramento Kings,98,34
374,374,Wed Dec 14 2016,Sacramento Kings,98,Houston Rockets,132,-34
1224,375,Wed Dec 14 2016,Memphis Grizzlies,93,Cleveland Cavaliers,85,8
375,375,Wed Dec 14 2016,Cleveland Cavaliers,85,Memphis Grizzlies,93,-8
1225,376,Wed Dec 14 2016,Miami Heat,95,Indiana Pacers,89,6
376,376,Wed Dec 14 2016,Indiana Pacers,89,Miami Heat,95,-6
377,377,Wed Dec 14 2016,Los Angeles Clippers,113,Orlando Magic,108,5
1226,377,Wed Dec 14 2016,Orlando Magic,108,Los Angeles Clippers,113,-5
378,378,Wed Dec 14 2016,Toronto Raptors,123,Philadelphia 76ers,114,9
1227,378,Wed Dec 14 2016,Philadelphia 76ers,114,Toronto Raptors,123,-9
1228,379,Wed Dec 14 2016,San Antonio Spurs,108,Boston Celtics,101,7
379,379,Wed Dec 14 2016,Boston Celtics,101,San Antonio Spurs,108,-7
1229,380,Wed Dec 14 2016,Utah Jazz,109,Oklahoma City Thunder,89,20
380,380,Wed Dec 14 2016,Oklahoma City Thunder,89,Utah Jazz,109,-20
1230,381,Wed Dec 14 2016,Washington Wizards,109,Charlotte Hornets,106,3
381,381,Wed Dec 14 2016,Charlotte Hornets,106,Washington Wizards,109,-3
382,382,Thu Dec 15 2016,Portland Trail Blazers,120,Denver Nuggets,132,-12
1231,382,Thu Dec 15 2016,Denver Nuggets,132,Portland Trail Blazers,120,12
1232,383,Thu Dec 15 2016,Golden State Warriors,103,New York Knicks,90,13
383,383,Thu Dec 15 2016,New York Knicks,90,Golden State Warriors,103,-13
1233,384,Thu Dec 15 2016,Milwaukee Bucks,108,Chicago Bulls,97,11
384,384,Thu Dec 15 2016,Chicago Bulls,97,Milwaukee Bucks,108,-11
1234,385,Thu Dec 15 2016,New Orleans Pelicans,102,Indiana Pacers,95,7
385,385,Thu Dec 15 2016,Indiana Pacers,95,New Orleans Pelicans,102,-7
386,386,Thu Dec 15 2016,San Antonio Spurs,107,Phoenix Suns,92,15
1235,386,Thu Dec 15 2016,Phoenix Suns,92,San Antonio Spurs,107,-15
1236,387,Fri Dec 16 2016,Boston Celtics,96,Charlotte Hornets,88,8
387,387,Fri Dec 16 2016,Charlotte Hornets,88,Boston Celtics,96,-8
1237,388,Fri Dec 16 2016,Chicago Bulls,69,Milwaukee Bucks,95,-26
388,388,Fri Dec 16 2016,Milwaukee Bucks,95,Chicago Bulls,69,26
389,389,Fri Dec 16 2016,New Orleans Pelicans,100,Houston Rockets,122,-22
1238,389,Fri Dec 16 2016,Houston Rockets,122,New Orleans Pelicans,100,22
1239,390,Fri Dec 16 2016,Memphis Grizzlies,92,Sacramento Kings,96,-4
390,390,Fri Dec 16 2016,Sacramento Kings,96,Memphis Grizzlies,92,4
391,391,Fri Dec 16 2016,Los Angeles Clippers,102,Miami Heat,98,4
1240,391,Fri Dec 16 2016,Miami Heat,98,Los Angeles Clippers,102,-4
1241,392,Fri Dec 16 2016,Orlando Magic,118,Brooklyn Nets,111,7
392,392,Fri Dec 16 2016,Brooklyn Nets,111,Orlando Magic,118,-7
1242,393,Fri Dec 16 2016,Philadelphia 76ers,89,Los Angeles Lakers,100,-11
393,393,Fri Dec 16 2016,Los Angeles Lakers,100,Philadelphia 76ers,89,11
1243,394,Fri Dec 16 2016,Toronto Raptors,121,Atlanta Hawks,125,-4
394,394,Fri Dec 16 2016,Atlanta Hawks,125,Toronto Raptors,121,4
395,395,Fri Dec 16 2016,Dallas Mavericks,100,Utah Jazz,103,-3
1244,395,Fri Dec 16 2016,Utah Jazz,103,Dallas Mavericks,100,3
396,396,Fri Dec 16 2016,Detroit Pistons,108,Washington Wizards,122,-14
1245,396,Fri Dec 16 2016,Washington Wizards,122,Detroit Pistons,108,14
397,397,Sat Dec 17 2016,Charlotte Hornets,107,Atlanta Hawks,99,8
1246,397,Sat Dec 17 2016,Atlanta Hawks,99,Charlotte Hornets,107,-8
398,398,Sat Dec 17 2016,Los Angeles Lakers,108,Cleveland Cavaliers,119,-11
1247,398,Sat Dec 17 2016,Cleveland Cavaliers,119,Los Angeles Lakers,108,11
399,399,Sat Dec 17 2016,New York Knicks,114,Denver Nuggets,127,-13
1248,399,Sat Dec 17 2016,Denver Nuggets,127,New York Knicks,114,13
1249,400,Sat Dec 17 2016,Detroit Pistons,90,Indiana Pacers,105,-15
400,400,Sat Dec 17 2016,Indiana Pacers,105,Detroit Pistons,90,15
1250,401,Sat Dec 17 2016,Golden State Warriors,135,Portland Trail Blazers,90,45
401,401,Sat Dec 17 2016,Portland Trail Blazers,90,Golden State Warriors,135,-45
1251,402,Sat Dec 17 2016,Minnesota Timberwolves,109,Houston Rockets,111,-2
402,402,Sat Dec 17 2016,Houston Rockets,111,Minnesota Timberwolves,109,2
1252,403,Sat Dec 17 2016,Oklahoma City Thunder,114,Phoenix Suns,101,13
403,403,Sat Dec 17 2016,Phoenix Suns,101,Oklahoma City Thunder,114,-13
1253,404,Sun Dec 18 2016,Dallas Mavericks,99,Sacramento Kings,79,20
404,404,Sun Dec 18 2016,Sacramento Kings,79,Dallas Mavericks,99,-20
1254,405,Sun Dec 18 2016,Memphis Grizzlies,73,Utah Jazz,82,-9
405,405,Sun Dec 18 2016,Utah Jazz,82,Memphis Grizzlies,73,9
406,406,Sun Dec 18 2016,Boston Celtics,105,Miami Heat,95,10
1255,406,Sun Dec 18 2016,Miami Heat,95,Boston Celtics,105,-10
1256,407,Sun Dec 18 2016,Orlando Magic,79,Toronto Raptors,109,-30
407,407,Sun Dec 18 2016,Toronto Raptors,109,Orlando Magic,79,30
408,408,Sun Dec 18 2016,Brooklyn Nets,107,Philadelphia 76ers,108,-1
1257,408,Sun Dec 18 2016,Philadelphia 76ers,108,Brooklyn Nets,107,1
409,409,Sun Dec 18 2016,New Orleans Pelicans,100,San Antonio Spurs,113,-13
1258,409,Sun Dec 18 2016,San Antonio Spurs,113,New Orleans Pelicans,100,13
410,410,Sun Dec 18 2016,Los Angeles Clippers,110,Washington Wizards,117,-7
1259,410,Sun Dec 18 2016,Washington Wizards,117,Los Angeles Clippers,110,7
1260,411,Mon Dec 19 2016,Chicago Bulls,113,Detroit Pistons,82,31
411,411,Mon Dec 19 2016,Detroit Pistons,82,Chicago Bulls,113,-31
412,412,Mon Dec 19 2016,Dallas Mavericks,107,Denver Nuggets,117,-10
1261,412,Mon Dec 19 2016,Denver Nuggets,117,Dallas Mavericks,107,10
413,413,Mon Dec 19 2016,Washington Wizards,105,Indiana Pacers,107,-2
1262,413,Mon Dec 19 2016,Indiana Pacers,107,Washington Wizards,105,2
414,414,Mon Dec 19 2016,Phoenix Suns,108,Minnesota Timberwolves,115,-7
1263,414,Mon Dec 19 2016,Minnesota Timberwolves,115,Phoenix Suns,108,7
415,415,Mon Dec 19 2016,Atlanta Hawks,110,Oklahoma City Thunder,108,2
1264,415,Mon Dec 19 2016,Oklahoma City Thunder,108,Atlanta Hawks,110,-2
1265,416,Tue Dec 20 2016,Charlotte Hornets,117,Los Angeles Lakers,113,4
416,416,Tue Dec 20 2016,Los Angeles Lakers,113,Charlotte Hornets,117,-4
417,417,Tue Dec 20 2016,Utah Jazz,74,Golden State Warriors,104,-30
1266,417,Tue Dec 20 2016,Golden State Warriors,104,Utah Jazz,74,30
418,418,Tue Dec 20 2016,San Antonio Spurs,102,Houston Rockets,100,2
1267,418,Tue Dec 20 2016,Houston Rockets,100,San Antonio Spurs,102,-2
419,419,Tue Dec 20 2016,Denver Nuggets,102,Los Angeles Clippers,119,-17
1268,419,Tue Dec 20 2016,Los Angeles Clippers,119,Denver Nuggets,102,17
1269,420,Tue Dec 20 2016,Memphis Grizzlies,109,Boston Celtics,112,-3
420,420,Tue Dec 20 2016,Boston Celtics,112,Memphis Grizzlies,109,3
1270,421,Tue Dec 20 2016,Miami Heat,130,Orlando Magic,136,-6
421,421,Tue Dec 20 2016,Orlando Magic,136,Miami Heat,130,6
1271,422,Tue Dec 20 2016,Milwaukee Bucks,108,Cleveland Cavaliers,114,-6
422,422,Tue Dec 20 2016,Cleveland Cavaliers,114,Milwaukee Bucks,108,6
423,423,Tue Dec 20 2016,Indiana Pacers,111,New York Knicks,118,-7
1272,423,Tue Dec 20 2016,New York Knicks,118,Indiana Pacers,111,7
1273,424,Tue Dec 20 2016,Philadelphia 76ers,93,New Orleans Pelicans,108,-15
424,424,Tue Dec 20 2016,New Orleans Pelicans,108,Philadelphia 76ers,93,15
1274,425,Tue Dec 20 2016,Sacramento Kings,126,Portland Trail Blazers,121,5
425,425,Tue Dec 20 2016,Portland Trail Blazers,121,Sacramento Kings,126,-5
426,426,Tue Dec 20 2016,Brooklyn Nets,104,Toronto Raptors,116,-12
1275,426,Tue Dec 20 2016,Toronto Raptors,116,Brooklyn Nets,104,12
427,427,Wed Dec 21 2016,Minnesota Timberwolves,92,Atlanta Hawks,84,8
1276,427,Wed Dec 21 2016,Atlanta Hawks,84,Minnesota Timberwolves,92,-8
1277,428,Wed Dec 21 2016,Chicago Bulls,97,Washington Wizards,107,-10
428,428,Wed Dec 21 2016,Washington Wizards,107,Chicago Bulls,97,10
1278,429,Wed Dec 21 2016,Cleveland Cavaliers,113,Milwaukee Bucks,102,11
429,429,Wed Dec 21 2016,Milwaukee Bucks,102,Cleveland Cavaliers,113,-11
1279,430,Wed Dec 21 2016,Detroit Pistons,86,Memphis Grizzlies,98,-12
430,430,Wed Dec 21 2016,Memphis Grizzlies,98,Detroit Pistons,86,12
1280,431,Wed Dec 21 2016,New Orleans Pelicans,110,Oklahoma City Thunder,121,-11
431,431,Wed Dec 21 2016,Oklahoma City Thunder,121,New Orleans Pelicans,110,11
432,432,Wed Dec 21 2016,Houston Rockets,125,Phoenix Suns,111,14
1281,432,Wed Dec 21 2016,Phoenix Suns,111,Houston Rockets,125,-14
1282,433,Wed Dec 21 2016,Portland Trail Blazers,95,Dallas Mavericks,96,-1
433,433,Wed Dec 21 2016,Dallas Mavericks,96,Portland Trail Blazers,95,1
1283,434,Wed Dec 21 2016,Utah Jazz,93,Sacramento Kings,94,-1
434,434,Wed Dec 21 2016,Sacramento Kings,94,Utah Jazz,93,1
435,435,Thu Dec 22 2016,Golden State Warriors,117,Brooklyn Nets,101,16
1284,435,Thu Dec 22 2016,Brooklyn Nets,101,Golden State Warriors,117,-16
436,436,Thu Dec 22 2016,Boston Celtics,109,Indiana Pacers,102,7
1285,436,Thu Dec 22 2016,Indiana Pacers,102,Boston Celtics,109,-7
1286,437,Thu Dec 22 2016,Los Angeles Clippers,106,San Antonio Spurs,101,5
437,437,Thu Dec 22 2016,San Antonio Spurs,101,Los Angeles Clippers,106,-5
1287,438,Thu Dec 22 2016,Miami Heat,115,Los Angeles Lakers,107,8
438,438,Thu Dec 22 2016,Los Angeles Lakers,107,Miami Heat,115,-8
439,439,Thu Dec 22 2016,Orlando Magic,95,New York Knicks,106,-11
1288,439,Thu Dec 22 2016,New York Knicks,106,Orlando Magic,95,11
1289,440,Fri Dec 23 2016,Boston Celtics,112,Oklahoma City Thunder,117,-5
440,440,Fri Dec 23 2016,Oklahoma City Thunder,117,Boston Celtics,112,5
1290,441,Fri Dec 23 2016,Charlotte Hornets,103,Chicago Bulls,91,12
441,441,Fri Dec 23 2016,Chicago Bulls,91,Charlotte Hornets,103,-12
1291,442,Fri Dec 23 2016,Cleveland Cavaliers,119,Brooklyn Nets,99,20
442,442,Fri Dec 23 2016,Brooklyn Nets,99,Cleveland Cavaliers,119,-20
1292,443,Fri Dec 23 2016,Denver Nuggets,108,Atlanta Hawks,109,-1
443,443,Fri Dec 23 2016,Atlanta Hawks,109,Denver Nuggets,108,1
1293,444,Fri Dec 23 2016,Detroit Pistons,113,Golden State Warriors,119,-6
444,444,Fri Dec 23 2016,Golden State Warriors,119,Detroit Pistons,113,6
445,445,Fri Dec 23 2016,Dallas Mavericks,90,Los Angeles Clippers,88,2
1294,445,Fri Dec 23 2016,Los Angeles Clippers,88,Dallas Mavericks,90,-2
446,446,Fri Dec 23 2016,Houston Rockets,109,Memphis Grizzlies,115,-6
1295,446,Fri Dec 23 2016,Memphis Grizzlies,115,Houston Rockets,109,6
1296,447,Fri Dec 23 2016,Milwaukee Bucks,123,Washington Wizards,96,27
447,447,Fri Dec 23 2016,Washington Wizards,96,Milwaukee Bucks,123,-27
448,448,Fri Dec 23 2016,Sacramento Kings,109,Minnesota Timberwolves,105,4
1297,448,Fri Dec 23 2016,Minnesota Timberwolves,105,Sacramento Kings,109,-4
449,449,Fri Dec 23 2016,Miami Heat,87,New Orleans Pelicans,91,-4
1298,449,Fri Dec 23 2016,New Orleans Pelicans,91,Miami Heat,87,4
1299,450,Fri Dec 23 2016,Orlando Magic,109,Los Angeles Lakers,90,19
450,450,Fri Dec 23 2016,Los Angeles Lakers,90,Orlando Magic,109,-19
1300,451,Fri Dec 23 2016,Phoenix Suns,123,Philadelphia 76ers,116,7
451,451,Fri Dec 23 2016,Philadelphia 76ers,116,Phoenix Suns,123,-7
1301,452,Fri Dec 23 2016,Portland Trail Blazers,90,San Antonio Spurs,110,-20
452,452,Fri Dec 23 2016,San Antonio Spurs,110,Portland Trail Blazers,90,20
1302,453,Fri Dec 23 2016,Utah Jazz,98,Toronto Raptors,104,-6
453,453,Fri Dec 23 2016,Toronto Raptors,104,Utah Jazz,98,6
454,454,Sun Dec 25 2016,Golden State Warriors,108,Cleveland Cavaliers,109,-1
1303,454,Sun Dec 25 2016,Cleveland Cavaliers,109,Golden State Warriors,108,1
455,455,Sun Dec 25 2016,Los Angeles Clippers,102,Los Angeles Lakers,111,-9
1304,455,Sun Dec 25 2016,Los Angeles Lakers,111,Los Angeles Clippers,102,9
1305,456,Sun Dec 25 2016,New York Knicks,114,Boston Celtics,119,-5
456,456,Sun Dec 25 2016,Boston Celtics,119,New York Knicks,114,5
1306,457,Sun Dec 25 2016,Oklahoma City Thunder,112,Minnesota Timberwolves,100,12
457,457,Sun Dec 25 2016,Minnesota Timberwolves,100,Oklahoma City Thunder,112,-12
1307,458,Sun Dec 25 2016,San Antonio Spurs,119,Chicago Bulls,100,19
458,458,Sun Dec 25 2016,Chicago Bulls,100,San Antonio Spurs,119,-19
1308,459,Mon Dec 26 2016,Brooklyn Nets,120,Charlotte Hornets,118,2
459,459,Mon Dec 26 2016,Charlotte Hornets,118,Brooklyn Nets,120,-2
1309,460,Mon Dec 26 2016,Chicago Bulls,90,Indiana Pacers,85,5
460,460,Mon Dec 26 2016,Indiana Pacers,85,Chicago Bulls,90,-5
1310,461,Mon Dec 26 2016,Detroit Pistons,106,Cleveland Cavaliers,90,16
461,461,Mon Dec 26 2016,Cleveland Cavaliers,90,Detroit Pistons,106,-16
462,462,Mon Dec 26 2016,Phoenix Suns,115,Houston Rockets,131,-16
1311,462,Mon Dec 26 2016,Houston Rockets,131,Phoenix Suns,115,16
463,463,Mon Dec 26 2016,Denver Nuggets,106,Los Angeles Clippers,102,4
1312,463,Mon Dec 26 2016,Los Angeles Clippers,102,Denver Nuggets,106,-4
464,464,Mon Dec 26 2016,Atlanta Hawks,90,Minnesota Timberwolves,104,-14
1313,464,Mon Dec 26 2016,Minnesota Timberwolves,104,Atlanta Hawks,90,14
465,465,Mon Dec 26 2016,Dallas Mavericks,104,New Orleans Pelicans,111,-7
1314,465,Mon Dec 26 2016,New Orleans Pelicans,111,Dallas Mavericks,104,7
1315,466,Mon Dec 26 2016,Orlando Magic,112,Memphis Grizzlies,102,10
466,466,Mon Dec 26 2016,Memphis Grizzlies,102,Orlando Magic,112,-10
467,467,Mon Dec 26 2016,Toronto Raptors,95,Portland Trail Blazers,91,4
1316,467,Mon Dec 26 2016,Portland Trail Blazers,91,Toronto Raptors,95,-4
468,468,Mon Dec 26 2016,Philadelphia 76ers,100,Sacramento Kings,102,-2
1317,468,Mon Dec 26 2016,Sacramento Kings,102,Philadelphia 76ers,100,2
1318,469,Mon Dec 26 2016,Washington Wizards,107,Milwaukee Bucks,102,5
469,469,Mon Dec 26 2016,Milwaukee Bucks,102,Washington Wizards,107,-5
1319,470,Tue Dec 27 2016,Boston Celtics,113,Memphis Grizzlies,103,10
470,470,Tue Dec 27 2016,Memphis Grizzlies,103,Boston Celtics,113,-10
1320,471,Tue Dec 27 2016,Dallas Mavericks,107,Houston Rockets,123,-16
471,471,Tue Dec 27 2016,Houston Rockets,123,Dallas Mavericks,107,16
472,472,Tue Dec 27 2016,Utah Jazz,102,Los Angeles Lakers,100,2
1321,472,Tue Dec 27 2016,Los Angeles Lakers,100,Utah Jazz,102,-2
1322,473,Tue Dec 27 2016,Miami Heat,94,Oklahoma City Thunder,106,-12
473,473,Tue Dec 27 2016,Oklahoma City Thunder,106,Miami Heat,94,12
474,474,Wed Dec 28 2016,New York Knicks,98,Atlanta Hawks,102,-4
1323,474,Wed Dec 28 2016,Atlanta Hawks,102,New York Knicks,98,4
475,475,Wed Dec 28 2016,Brooklyn Nets,99,Chicago Bulls,101,-2
1324,475,Wed Dec 28 2016,Chicago Bulls,101,Brooklyn Nets,99,2
476,476,Wed Dec 28 2016,Minnesota Timberwolves,103,Denver Nuggets,105,-2
1325,476,Wed Dec 28 2016,Denver Nuggets,105,Minnesota Timberwolves,103,2
1326,477,Wed Dec 28 2016,Detroit Pistons,94,Milwaukee Bucks,119,-25
477,477,Wed Dec 28 2016,Milwaukee Bucks,119,Detroit Pistons,94,25
1327,478,Wed Dec 28 2016,Golden State Warriors,121,Toronto Raptors,111,10
478,478,Wed Dec 28 2016,Toronto Raptors,111,Golden State Warriors,121,-10
1328,479,Wed Dec 28 2016,New Orleans Pelicans,102,Los Angeles Clippers,98,4
479,479,Wed Dec 28 2016,Los Angeles Clippers,98,New Orleans Pelicans,102,-4
1329,480,Wed Dec 28 2016,Orlando Magic,101,Charlotte Hornets,120,-19
480,480,Wed Dec 28 2016,Charlotte Hornets,120,Orlando Magic,101,19
1330,481,Wed Dec 28 2016,Portland Trail Blazers,102,Sacramento Kings,89,13
481,481,Wed Dec 28 2016,Sacramento Kings,89,Portland Trail Blazers,102,-13
482,482,Wed Dec 28 2016,Phoenix Suns,98,San Antonio Spurs,119,-21
1331,482,Wed Dec 28 2016,San Antonio Spurs,119,Phoenix Suns,98,21
1332,483,Wed Dec 28 2016,Washington Wizards,111,Indiana Pacers,105,6
483,483,Wed Dec 28 2016,Indiana Pacers,105,Washington Wizards,111,-6
484,484,Thu Dec 29 2016,Miami Heat,82,Charlotte Hornets,91,-9
1333,484,Thu Dec 29 2016,Charlotte Hornets,91,Miami Heat,82,9
485,485,Thu Dec 29 2016,Boston Celtics,118,Cleveland Cavaliers,124,-6
1334,485,Thu Dec 29 2016,Cleveland Cavaliers,124,Boston Celtics,118,6
486,486,Thu Dec 29 2016,Dallas Mavericks,101,Los Angeles Lakers,89,12
1335,486,Thu Dec 29 2016,Los Angeles Lakers,89,Dallas Mavericks,101,-12
487,487,Thu Dec 29 2016,Oklahoma City Thunder,80,Memphis Grizzlies,114,-34
1336,487,Thu Dec 29 2016,Memphis Grizzlies,114,Oklahoma City Thunder,80,34
1337,488,Thu Dec 29 2016,Phoenix Suns,99,Toronto Raptors,91,8
488,488,Thu Dec 29 2016,Toronto Raptors,91,Phoenix Suns,99,-8
1338,489,Thu Dec 29 2016,Utah Jazz,100,Philadelphia 76ers,83,17
489,489,Thu Dec 29 2016,Philadelphia 76ers,83,Utah Jazz,100,-17
490,490,Fri Dec 30 2016,Detroit Pistons,98,Atlanta Hawks,105,-7
1339,490,Fri Dec 30 2016,Atlanta Hawks,105,Detroit Pistons,98,7
1340,491,Fri Dec 30 2016,Boston Celtics,117,Miami Heat,114,3
491,491,Fri Dec 30 2016,Miami Heat,114,Boston Celtics,117,-3
1341,492,Fri Dec 30 2016,Denver Nuggets,122,Philadelphia 76ers,124,-2
492,492,Fri Dec 30 2016,Philadelphia 76ers,124,Denver Nuggets,122,2
493,493,Fri Dec 30 2016,Dallas Mavericks,99,Golden State Warriors,108,-9
1342,493,Fri Dec 30 2016,Golden State Warriors,108,Dallas Mavericks,99,9
494,494,Fri Dec 30 2016,Los Angeles Clippers,116,Houston Rockets,140,-24
1343,494,Fri Dec 30 2016,Houston Rockets,140,Los Angeles Clippers,116,24
495,495,Fri Dec 30 2016,Chicago Bulls,101,Indiana Pacers,111,-10
1344,495,Fri Dec 30 2016,Indiana Pacers,111,Chicago Bulls,101,10
496,496,Fri Dec 30 2016,Milwaukee Bucks,99,Minnesota Timberwolves,116,-17
1345,496,Fri Dec 30 2016,Minnesota Timberwolves,116,Milwaukee Bucks,99,17
1346,497,Fri Dec 30 2016,New Orleans Pelicans,104,New York Knicks,92,12
497,497,Fri Dec 30 2016,New York Knicks,92,New Orleans Pelicans,104,-12
1347,498,Fri Dec 30 2016,San Antonio Spurs,110,Portland Trail Blazers,94,16
498,498,Fri Dec 30 2016,Portland Trail Blazers,94,San Antonio Spurs,110,-16
1348,499,Fri Dec 30 2016,Washington Wizards,118,Brooklyn Nets,95,23
499,499,Fri Dec 30 2016,Brooklyn Nets,95,Washington Wizards,118,-23
500,500,Sat Dec 31 2016,Milwaukee Bucks,116,Chicago Bulls,96,20
1349,500,Sat Dec 31 2016,Chicago Bulls,96,Milwaukee Bucks,116,-20
501,501,Sat Dec 31 2016,Cleveland Cavaliers,121,Charlotte Hornets,109,12
1350,501,Sat Dec 31 2016,Charlotte Hornets,109,Cleveland Cavaliers,121,-12
1351,502,Sat Dec 31 2016,Houston Rockets,129,New York Knicks,122,7
502,502,Sat Dec 31 2016,New York Knicks,122,Houston Rockets,129,-7
1352,503,Sat Dec 31 2016,Oklahoma City Thunder,114,Los Angeles Clippers,88,26
503,503,Sat Dec 31 2016,Los Angeles Clippers,88,Oklahoma City Thunder,114,-26
1353,504,Sat Dec 31 2016,Sacramento Kings,98,Memphis Grizzlies,112,-14
504,504,Sat Dec 31 2016,Memphis Grizzlies,112,Sacramento Kings,98,14
1354,505,Sat Dec 31 2016,Utah Jazz,91,Phoenix Suns,86,5
505,505,Sat Dec 31 2016,Phoenix Suns,86,Utah Jazz,91,-5
1355,506,Sun Jan 1 2017,Atlanta Hawks,114,San Antonio Spurs,112,2
506,506,Sun Jan 1 2017,San Antonio Spurs,112,Atlanta Hawks,114,-2
1356,507,Sun Jan 1 2017,Indiana Pacers,117,Orlando Magic,104,13
507,507,Sun Jan 1 2017,Orlando Magic,104,Indiana Pacers,117,-13
1357,508,Sun Jan 1 2017,Los Angeles Lakers,114,Toronto Raptors,123,-9
508,508,Sun Jan 1 2017,Toronto Raptors,123,Los Angeles Lakers,114,9
1358,509,Sun Jan 1 2017,Miami Heat,98,Detroit Pistons,107,-9
509,509,Sun Jan 1 2017,Detroit Pistons,107,Miami Heat,98,9
510,510,Sun Jan 1 2017,Portland Trail Blazers,95,Minnesota Timberwolves,89,6
1359,510,Sun Jan 1 2017,Minnesota Timberwolves,89,Portland Trail Blazers,95,-6
511,511,Mon Jan 2 2017,Utah Jazz,101,Brooklyn Nets,89,12
1360,511,Mon Jan 2 2017,Brooklyn Nets,89,Utah Jazz,101,-12
512,512,Mon Jan 2 2017,Charlotte Hornets,111,Chicago Bulls,118,-7
1361,512,Mon Jan 2 2017,Chicago Bulls,118,Charlotte Hornets,111,7
513,513,Mon Jan 2 2017,New Orleans Pelicans,82,Cleveland Cavaliers,90,-8
1362,513,Mon Jan 2 2017,Cleveland Cavaliers,90,New Orleans Pelicans,82,8
1363,514,Mon Jan 2 2017,Golden State Warriors,127,Denver Nuggets,119,8
514,514,Mon Jan 2 2017,Denver Nuggets,119,Golden State Warriors,127,-8
1364,515,Mon Jan 2 2017,Houston Rockets,101,Washington Wizards,91,10
515,515,Mon Jan 2 2017,Washington Wizards,91,Houston Rockets,101,-10
1365,516,Mon Jan 2 2017,Los Angeles Clippers,109,Phoenix Suns,98,11
516,516,Mon Jan 2 2017,Phoenix Suns,98,Los Angeles Clippers,109,-11
1366,517,Mon Jan 2 2017,Milwaukee Bucks,98,Oklahoma City Thunder,94,4
517,517,Mon Jan 2 2017,Oklahoma City Thunder,94,Milwaukee Bucks,98,-4
1367,518,Mon Jan 2 2017,New York Knicks,103,Orlando Magic,115,-12
518,518,Mon Jan 2 2017,Orlando Magic,115,New York Knicks,103,12
1368,519,Tue Jan 3 2017,Boston Celtics,115,Utah Jazz,104,11
519,519,Tue Jan 3 2017,Utah Jazz,104,Boston Celtics,115,-11
520,520,Tue Jan 3 2017,Washington Wizards,105,Dallas Mavericks,113,-8
1369,520,Tue Jan 3 2017,Dallas Mavericks,113,Washington Wizards,105,8
521,521,Tue Jan 3 2017,Sacramento Kings,120,Denver Nuggets,113,7
1370,521,Tue Jan 3 2017,Denver Nuggets,113,Sacramento Kings,120,-7
1371,522,Tue Jan 3 2017,Detroit Pistons,116,Indiana Pacers,121,-5
522,522,Tue Jan 3 2017,Indiana Pacers,121,Detroit Pistons,116,5
523,523,Tue Jan 3 2017,Memphis Grizzlies,102,Los Angeles Lakers,116,-14
1372,523,Tue Jan 3 2017,Los Angeles Lakers,116,Memphis Grizzlies,102,14
1373,524,Tue Jan 3 2017,Philadelphia 76ers,93,Minnesota Timberwolves,91,2
524,524,Tue Jan 3 2017,Minnesota Timberwolves,91,Philadelphia 76ers,93,-2
1374,525,Tue Jan 3 2017,Phoenix Suns,99,Miami Heat,90,9
525,525,Tue Jan 3 2017,Miami Heat,90,Phoenix Suns,99,-9
1375,526,Tue Jan 3 2017,San Antonio Spurs,110,Toronto Raptors,82,28
526,526,Tue Jan 3 2017,Toronto Raptors,82,San Antonio Spurs,110,-28
1376,527,Wed Jan 4 2017,Charlotte Hornets,123,Oklahoma City Thunder,112,11
527,527,Wed Jan 4 2017,Oklahoma City Thunder,112,Charlotte Hornets,123,-11
528,528,Wed Jan 4 2017,Chicago Bulls,106,Cleveland Cavaliers,94,12
1377,528,Wed Jan 4 2017,Cleveland Cavaliers,94,Chicago Bulls,106,-12
529,529,Wed Jan 4 2017,Portland Trail Blazers,117,Golden State Warriors,125,-8
1378,529,Wed Jan 4 2017,Golden State Warriors,125,Portland Trail Blazers,117,8
1379,530,Wed Jan 4 2017,Los Angeles Clippers,115,Memphis Grizzlies,106,9
530,530,Wed Jan 4 2017,Memphis Grizzlies,106,Los Angeles Clippers,115,-9
531,531,Wed Jan 4 2017,Milwaukee Bucks,105,New York Knicks,104,1
1380,531,Wed Jan 4 2017,New York Knicks,104,Milwaukee Bucks,105,-1
532,532,Wed Jan 4 2017,Atlanta Hawks,111,Orlando Magic,92,19
1381,532,Wed Jan 4 2017,Orlando Magic,92,Atlanta Hawks,111,-19
533,533,Wed Jan 4 2017,Miami Heat,107,Sacramento Kings,102,5
1382,533,Wed Jan 4 2017,Sacramento Kings,102,Miami Heat,107,-5
1383,534,Thu Jan 5 2017,Dallas Mavericks,95,Phoenix Suns,102,-7
534,534,Thu Jan 5 2017,Phoenix Suns,102,Dallas Mavericks,95,7
1384,535,Thu Jan 5 2017,Denver Nuggets,99,San Antonio Spurs,127,-28
535,535,Thu Jan 5 2017,San Antonio Spurs,127,Denver Nuggets,99,28
1385,536,Thu Jan 5 2017,Detroit Pistons,115,Charlotte Hornets,114,1
536,536,Thu Jan 5 2017,Charlotte Hornets,114,Detroit Pistons,115,-1
1386,537,Thu Jan 5 2017,Houston Rockets,118,Oklahoma City Thunder,116,2
537,537,Thu Jan 5 2017,Oklahoma City Thunder,116,Houston Rockets,118,-2
1387,538,Thu Jan 5 2017,Indiana Pacers,121,Brooklyn Nets,109,12
538,538,Thu Jan 5 2017,Brooklyn Nets,109,Indiana Pacers,121,-12
1388,539,Thu Jan 5 2017,New Orleans Pelicans,94,Atlanta Hawks,99,-5
539,539,Thu Jan 5 2017,Atlanta Hawks,99,New Orleans Pelicans,94,5
1389,540,Thu Jan 5 2017,Portland Trail Blazers,118,Los Angeles Lakers,109,9
540,540,Thu Jan 5 2017,Los Angeles Lakers,109,Portland Trail Blazers,118,-9
1390,541,Thu Jan 5 2017,Toronto Raptors,101,Utah Jazz,93,8
541,541,Thu Jan 5 2017,Utah Jazz,93,Toronto Raptors,101,-8
1391,542,Fri Jan 6 2017,Boston Celtics,110,Philadelphia 76ers,106,4
542,542,Fri Jan 6 2017,Philadelphia 76ers,106,Boston Celtics,110,-4
543,543,Fri Jan 6 2017,Cleveland Cavaliers,116,Brooklyn Nets,108,8
1392,543,Fri Jan 6 2017,Brooklyn Nets,108,Cleveland Cavaliers,116,-8
1393,544,Fri Jan 6 2017,Golden State Warriors,119,Memphis Grizzlies,128,-9
544,544,Fri Jan 6 2017,Memphis Grizzlies,128,Golden State Warriors,119,9
545,545,Fri Jan 6 2017,Miami Heat,100,Los Angeles Lakers,127,-27
1394,545,Fri Jan 6 2017,Los Angeles Lakers,127,Miami Heat,100,27
546,546,Fri Jan 6 2017,New York Knicks,116,Milwaukee Bucks,111,5
1395,546,Fri Jan 6 2017,Milwaukee Bucks,111,New York Knicks,116,-5
547,547,Fri Jan 6 2017,Houston Rockets,100,Orlando Magic,93,7
1396,547,Fri Jan 6 2017,Orlando Magic,93,Houston Rockets,100,-7
548,548,Fri Jan 6 2017,Los Angeles Clippers,106,Sacramento Kings,98,8
1397,548,Fri Jan 6 2017,Sacramento Kings,98,Los Angeles Clippers,106,-8
549,549,Fri Jan 6 2017,Minnesota Timberwolves,105,Washington Wizards,112,-7
1398,549,Fri Jan 6 2017,Washington Wizards,112,Minnesota Timberwolves,105,7
550,550,Sat Jan 7 2017,New Orleans Pelicans,108,Boston Celtics,117,-9
1399,550,Sat Jan 7 2017,Boston Celtics,117,New Orleans Pelicans,108,9
551,551,Sat Jan 7 2017,Toronto Raptors,118,Chicago Bulls,123,-5
1400,551,Sat Jan 7 2017,Chicago Bulls,123,Toronto Raptors,118,5
1401,552,Sat Jan 7 2017,Dallas Mavericks,82,Atlanta Hawks,97,-15
552,552,Sat Jan 7 2017,Atlanta Hawks,97,Dallas Mavericks,82,15
553,553,Sat Jan 7 2017,New York Knicks,109,Indiana Pacers,123,-14
1402,553,Sat Jan 7 2017,Indiana Pacers,123,New York Knicks,109,14
1403,554,Sat Jan 7 2017,Minnesota Timberwolves,92,Utah Jazz,94,-2
554,554,Sat Jan 7 2017,Utah Jazz,94,Minnesota Timberwolves,92,2
1404,555,Sat Jan 7 2017,Oklahoma City Thunder,121,Denver Nuggets,106,15
555,555,Sat Jan 7 2017,Denver Nuggets,106,Oklahoma City Thunder,121,-15
1405,556,Sat Jan 7 2017,San Antonio Spurs,102,Charlotte Hornets,85,17
556,556,Sat Jan 7 2017,Charlotte Hornets,85,San Antonio Spurs,102,-17
1406,557,Sun Jan 8 2017,Brooklyn Nets,95,Philadelphia 76ers,105,-10
557,557,Sun Jan 8 2017,Philadelphia 76ers,105,Brooklyn Nets,95,10
1407,558,Sun Jan 8 2017,Los Angeles Clippers,98,Miami Heat,86,12
558,558,Sun Jan 8 2017,Miami Heat,86,Los Angeles Clippers,98,-12
559,559,Sun Jan 8 2017,Orlando Magic,95,Los Angeles Lakers,111,-16
1408,559,Sun Jan 8 2017,Los Angeles Lakers,111,Orlando Magic,95,16
560,560,Sun Jan 8 2017,Utah Jazz,79,Memphis Grizzlies,88,-9
1409,560,Sun Jan 8 2017,Memphis Grizzlies,88,Utah Jazz,79,9
561,561,Sun Jan 8 2017,Washington Wizards,107,Milwaukee Bucks,101,6
1410,561,Sun Jan 8 2017,Milwaukee Bucks,101,Washington Wizards,107,-6
562,562,Sun Jan 8 2017,Cleveland Cavaliers,120,Phoenix Suns,116,4
1411,562,Sun Jan 8 2017,Phoenix Suns,116,Cleveland Cavaliers,120,-4
1412,563,Sun Jan 8 2017,Portland Trail Blazers,124,Detroit Pistons,125,-1
563,563,Sun Jan 8 2017,Detroit Pistons,125,Portland Trail Blazers,124,1
564,564,Sun Jan 8 2017,Golden State Warriors,117,Sacramento Kings,106,11
1413,564,Sun Jan 8 2017,Sacramento Kings,106,Golden State Warriors,117,-11
1414,565,Sun Jan 8 2017,Toronto Raptors,122,Houston Rockets,129,-7
565,565,Sun Jan 8 2017,Houston Rockets,129,Toronto Raptors,122,7
1415,566,Mon Jan 9 2017,Chicago Bulls,94,Oklahoma City Thunder,109,-15
566,566,Mon Jan 9 2017,Oklahoma City Thunder,109,Chicago Bulls,94,15
1416,567,Mon Jan 9 2017,Minnesota Timberwolves,101,Dallas Mavericks,92,9
567,567,Mon Jan 9 2017,Dallas Mavericks,92,Minnesota Timberwolves,101,-9
1417,568,Mon Jan 9 2017,New York Knicks,96,New Orleans Pelicans,110,-14
568,568,Mon Jan 9 2017,New Orleans Pelicans,110,New York Knicks,96,14
569,569,Tue Jan 10 2017,Atlanta Hawks,117,Brooklyn Nets,97,20
1418,569,Tue Jan 10 2017,Brooklyn Nets,97,Atlanta Hawks,117,-20
1419,570,Tue Jan 10 2017,Golden State Warriors,107,Miami Heat,95,12
570,570,Tue Jan 10 2017,Miami Heat,95,Golden State Warriors,107,-12
571,571,Tue Jan 10 2017,Charlotte Hornets,114,Houston Rockets,121,-7
1420,571,Tue Jan 10 2017,Houston Rockets,121,Charlotte Hornets,114,7
572,572,Tue Jan 10 2017,Portland Trail Blazers,108,Los Angeles Lakers,87,21
1421,572,Tue Jan 10 2017,Los Angeles Lakers,87,Portland Trail Blazers,108,-21
573,573,Tue Jan 10 2017,Detroit Pistons,94,Sacramento Kings,100,-6
1422,573,Tue Jan 10 2017,Sacramento Kings,100,Detroit Pistons,94,6
1423,574,Tue Jan 10 2017,San Antonio Spurs,107,Milwaukee Bucks,109,-2
574,574,Tue Jan 10 2017,Milwaukee Bucks,109,San Antonio Spurs,107,2
1424,575,Tue Jan 10 2017,Toronto Raptors,114,Boston Celtics,106,8
575,575,Tue Jan 10 2017,Boston Celtics,106,Toronto Raptors,114,-8
1425,576,Tue Jan 10 2017,Utah Jazz,100,Cleveland Cavaliers,92,8
576,576,Tue Jan 10 2017,Cleveland Cavaliers,92,Utah Jazz,100,-8
577,577,Tue Jan 10 2017,Chicago Bulls,99,Washington Wizards,101,-2
1426,577,Tue Jan 10 2017,Washington Wizards,101,Chicago Bulls,99,2
1427,578,Wed Jan 11 2017,Boston Celtics,117,Washington Wizards,108,9
578,578,Wed Jan 11 2017,Washington Wizards,108,Boston Celtics,117,-9
1428,579,Wed Jan 11 2017,Los Angeles Clippers,105,Orlando Magic,96,9
579,579,Wed Jan 11 2017,Orlando Magic,96,Los Angeles Clippers,105,-9
580,580,Wed Jan 11 2017,Houston Rockets,105,Minnesota Timberwolves,119,-14
1429,580,Wed Jan 11 2017,Minnesota Timberwolves,119,Houston Rockets,105,14
1430,581,Wed Jan 11 2017,Oklahoma City Thunder,103,Memphis Grizzlies,95,8
581,581,Wed Jan 11 2017,Memphis Grizzlies,95,Oklahoma City Thunder,103,-8
582,582,Wed Jan 11 2017,New York Knicks,97,Philadelphia 76ers,98,-1
1431,582,Wed Jan 11 2017,Philadelphia 76ers,98,New York Knicks,97,1
1432,583,Wed Jan 11 2017,Portland Trail Blazers,102,Cleveland Cavaliers,86,16
583,583,Wed Jan 11 2017,Cleveland Cavaliers,86,Portland Trail Blazers,102,-16
584,584,Thu Jan 12 2017,New Orleans Pelicans,104,Brooklyn Nets,95,9
1433,584,Thu Jan 12 2017,Brooklyn Nets,95,New Orleans Pelicans,104,-9
1434,585,Thu Jan 12 2017,Denver Nuggets,140,Indiana Pacers,112,28
585,585,Thu Jan 12 2017,Indiana Pacers,112,Denver Nuggets,140,-28
586,586,Thu Jan 12 2017,Detroit Pistons,107,Golden State Warriors,127,-20
1435,586,Thu Jan 12 2017,Golden State Warriors,127,Detroit Pistons,107,20
1436,587,Thu Jan 12 2017,New York Knicks,104,Chicago Bulls,89,15
587,587,Thu Jan 12 2017,Chicago Bulls,89,New York Knicks,104,-15
1437,588,Thu Jan 12 2017,Phoenix Suns,108,Dallas Mavericks,113,-5
588,588,Thu Jan 12 2017,Dallas Mavericks,113,Phoenix Suns,108,5
589,589,Thu Jan 12 2017,Los Angeles Lakers,94,San Antonio Spurs,134,-40
1438,589,Thu Jan 12 2017,San Antonio Spurs,134,Los Angeles Lakers,94,40
1439,590,Fri Jan 13 2017,Atlanta Hawks,101,Boston Celtics,103,-2
590,590,Fri Jan 13 2017,Boston Celtics,103,Atlanta Hawks,101,2
591,591,Fri Jan 13 2017,Memphis Grizzlies,110,Houston Rockets,105,5
1440,591,Fri Jan 13 2017,Houston Rockets,105,Memphis Grizzlies,110,-5
1441,592,Fri Jan 13 2017,Milwaukee Bucks,116,Miami Heat,108,8
592,592,Fri Jan 13 2017,Miami Heat,108,Milwaukee Bucks,116,-8
1442,593,Fri Jan 13 2017,Minnesota Timberwolves,96,Oklahoma City Thunder,86,10
593,593,Fri Jan 13 2017,Oklahoma City Thunder,86,Minnesota Timberwolves,96,-10
1443,594,Fri Jan 13 2017,Philadelphia 76ers,102,Charlotte Hornets,93,9
594,594,Fri Jan 13 2017,Charlotte Hornets,93,Philadelphia 76ers,102,-9
595,595,Fri Jan 13 2017,Orlando Magic,115,Portland Trail Blazers,109,6
1444,595,Fri Jan 13 2017,Portland Trail Blazers,109,Orlando Magic,115,-6
596,596,Fri Jan 13 2017,Cleveland Cavaliers,120,Sacramento Kings,108,12
1445,596,Fri Jan 13 2017,Sacramento Kings,108,Cleveland Cavaliers,120,-12
597,597,Fri Jan 13 2017,Brooklyn Nets,113,Toronto Raptors,132,-19
1446,597,Fri Jan 13 2017,Toronto Raptors,132,Brooklyn Nets,113,19
1447,598,Fri Jan 13 2017,Utah Jazz,110,Detroit Pistons,77,33
598,598,Fri Jan 13 2017,Detroit Pistons,77,Utah Jazz,110,-33
599,599,Sat Jan 14 2017,New Orleans Pelicans,99,Chicago Bulls,107,-8
1448,599,Sat Jan 14 2017,Chicago Bulls,107,New Orleans Pelicans,99,8
600,600,Sat Jan 14 2017,Los Angeles Lakers,97,Los Angeles Clippers,113,-16
1449,600,Sat Jan 14 2017,Los Angeles Clippers,113,Los Angeles Lakers,97,16
1450,601,Sat Jan 14 2017,Phoenix Suns,108,San Antonio Spurs,105,3
601,601,Sat Jan 14 2017,San Antonio Spurs,105,Phoenix Suns,108,-3
602,602,Sat Jan 14 2017,Orlando Magic,107,Utah Jazz,114,-7
1451,602,Sat Jan 14 2017,Utah Jazz,114,Orlando Magic,107,7
603,603,Sat Jan 14 2017,Philadelphia 76ers,93,Washington Wizards,109,-16
1452,603,Sat Jan 14 2017,Washington Wizards,109,Philadelphia 76ers,93,16
604,604,Sun Jan 15 2017,Milwaukee Bucks,98,Atlanta Hawks,111,-13
1453,604,Sun Jan 15 2017,Atlanta Hawks,111,Milwaukee Bucks,98,13
605,605,Sun Jan 15 2017,Houston Rockets,137,Brooklyn Nets,112,25
1454,605,Sun Jan 15 2017,Brooklyn Nets,112,Houston Rockets,137,-25
1455,606,Sun Jan 15 2017,Dallas Mavericks,98,Minnesota Timberwolves,87,11
606,606,Sun Jan 15 2017,Minnesota Timberwolves,87,Dallas Mavericks,98,-11
1456,607,Sun Jan 15 2017,Los Angeles Lakers,97,Detroit Pistons,102,-5
607,607,Sun Jan 15 2017,Detroit Pistons,102,Los Angeles Lakers,97,5
1457,608,Sun Jan 15 2017,Memphis Grizzlies,104,Chicago Bulls,108,-4
608,608,Sun Jan 15 2017,Chicago Bulls,108,Memphis Grizzlies,104,4
609,609,Sun Jan 15 2017,Oklahoma City Thunder,122,Sacramento Kings,118,4
1458,609,Sun Jan 15 2017,Sacramento Kings,118,Oklahoma City Thunder,122,-4
610,610,Sun Jan 15 2017,New York Knicks,101,Toronto Raptors,116,-15
1459,610,Sun Jan 15 2017,Toronto Raptors,116,New York Knicks,101,15
611,611,Mon Jan 16 2017,Charlotte Hornets,98,Boston Celtics,108,-10
1460,611,Mon Jan 16 2017,Boston Celtics,108,Charlotte Hornets,98,10
612,612,Mon Jan 16 2017,Orlando Magic,112,Denver Nuggets,125,-13
1461,612,Mon Jan 16 2017,Denver Nuggets,125,Orlando Magic,112,13
1462,613,Mon Jan 16 2017,Golden State Warriors,126,Cleveland Cavaliers,91,35
613,613,Mon Jan 16 2017,Cleveland Cavaliers,91,Golden State Warriors,126,-35
1463,614,Mon Jan 16 2017,Indiana Pacers,98,New Orleans Pelicans,95,3
614,614,Mon Jan 16 2017,New Orleans Pelicans,95,Indiana Pacers,98,-3
615,615,Mon Jan 16 2017,Oklahoma City Thunder,98,Los Angeles Clippers,120,-22
1464,615,Mon Jan 16 2017,Los Angeles Clippers,120,Oklahoma City Thunder,98,22
616,616,Mon Jan 16 2017,Philadelphia 76ers,113,Milwaukee Bucks,104,9
1465,616,Mon Jan 16 2017,Milwaukee Bucks,104,Philadelphia 76ers,113,-9
617,617,Mon Jan 16 2017,Atlanta Hawks,108,New York Knicks,107,1
1466,617,Mon Jan 16 2017,New York Knicks,107,Atlanta Hawks,108,-1
618,618,Mon Jan 16 2017,Utah Jazz,106,Phoenix Suns,101,5
1467,618,Mon Jan 16 2017,Phoenix Suns,101,Utah Jazz,106,-5
1468,619,Mon Jan 16 2017,Washington Wizards,120,Portland Trail Blazers,101,19
619,619,Mon Jan 16 2017,Portland Trail Blazers,101,Washington Wizards,120,-19
620,620,Tue Jan 17 2017,Toronto Raptors,119,Brooklyn Nets,109,10
1469,620,Tue Jan 17 2017,Brooklyn Nets,109,Toronto Raptors,119,-10
621,621,Tue Jan 17 2017,Dallas Mavericks,99,Chicago Bulls,98,1
1470,621,Tue Jan 17 2017,Chicago Bulls,98,Dallas Mavericks,99,-1
622,622,Tue Jan 17 2017,Denver Nuggets,127,Los Angeles Lakers,121,6
1471,622,Tue Jan 17 2017,Los Angeles Lakers,121,Denver Nuggets,127,-6
1472,623,Tue Jan 17 2017,Miami Heat,109,Houston Rockets,103,6
623,623,Tue Jan 17 2017,Houston Rockets,103,Miami Heat,109,-6
1473,624,Tue Jan 17 2017,San Antonio Spurs,122,Minnesota Timberwolves,114,8
624,624,Tue Jan 17 2017,Minnesota Timberwolves,114,San Antonio Spurs,122,-8
1474,625,Wed Jan 18 2017,Boston Celtics,106,New York Knicks,117,-11
625,625,Wed Jan 18 2017,New York Knicks,117,Boston Celtics,106,11
626,626,Wed Jan 18 2017,Portland Trail Blazers,85,Charlotte Hornets,107,-22
1475,626,Wed Jan 18 2017,Charlotte Hornets,107,Portland Trail Blazers,85,22
1476,627,Wed Jan 18 2017,Detroit Pistons,118,Atlanta Hawks,95,23
627,627,Wed Jan 18 2017,Atlanta Hawks,95,Detroit Pistons,118,-23
628,628,Wed Jan 18 2017,Oklahoma City Thunder,100,Golden State Warriors,121,-21
1477,628,Wed Jan 18 2017,Golden State Warriors,121,Oklahoma City Thunder,100,21
1478,629,Wed Jan 18 2017,Houston Rockets,111,Milwaukee Bucks,92,19
629,629,Wed Jan 18 2017,Milwaukee Bucks,92,Houston Rockets,111,-19
1479,630,Wed Jan 18 2017,New Orleans Pelicans,118,Orlando Magic,98,20
630,630,Wed Jan 18 2017,Orlando Magic,98,New Orleans Pelicans,118,-20
631,631,Wed Jan 18 2017,Toronto Raptors,89,Philadelphia 76ers,94,-5
1480,631,Wed Jan 18 2017,Philadelphia 76ers,94,Toronto Raptors,89,5
1481,632,Wed Jan 18 2017,Sacramento Kings,100,Indiana Pacers,106,-6
632,632,Wed Jan 18 2017,Indiana Pacers,106,Sacramento Kings,100,6
1482,633,Wed Jan 18 2017,Washington Wizards,104,Memphis Grizzlies,101,3
633,633,Wed Jan 18 2017,Memphis Grizzlies,101,Washington Wizards,104,-3
1483,634,Thu Jan 19 2017,Cleveland Cavaliers,118,Phoenix Suns,103,15
634,634,Thu Jan 19 2017,Phoenix Suns,103,Cleveland Cavaliers,118,-15
1484,635,Thu Jan 19 2017,Los Angeles Clippers,101,Minnesota Timberwolves,104,-3
635,635,Thu Jan 19 2017,Minnesota Timberwolves,104,Los Angeles Clippers,101,3
1485,636,Thu Jan 19 2017,Miami Heat,99,Dallas Mavericks,95,4
636,636,Thu Jan 19 2017,Dallas Mavericks,95,Miami Heat,99,-4
637,637,Thu Jan 19 2017,Washington Wizards,113,New York Knicks,110,3
1486,637,Thu Jan 19 2017,New York Knicks,110,Washington Wizards,113,-3
638,638,Thu Jan 19 2017,Denver Nuggets,104,San Antonio Spurs,118,-14
1487,638,Thu Jan 19 2017,San Antonio Spurs,118,Denver Nuggets,104,14
1488,639,Fri Jan 20 2017,Atlanta Hawks,102,Chicago Bulls,93,9
639,639,Fri Jan 20 2017,Chicago Bulls,93,Atlanta Hawks,102,-9
640,640,Fri Jan 20 2017,Toronto Raptors,78,Charlotte Hornets,113,-35
1489,640,Fri Jan 20 2017,Charlotte Hornets,113,Toronto Raptors,78,35
641,641,Fri Jan 20 2017,Utah Jazz,112,Dallas Mavericks,107,5
1490,641,Fri Jan 20 2017,Dallas Mavericks,107,Utah Jazz,112,-5
642,642,Fri Jan 20 2017,Golden State Warriors,125,Houston Rockets,108,17
1491,642,Fri Jan 20 2017,Houston Rockets,108,Golden State Warriors,125,-17
643,643,Fri Jan 20 2017,Indiana Pacers,95,Los Angeles Lakers,108,-13
1492,643,Fri Jan 20 2017,Los Angeles Lakers,108,Indiana Pacers,95,13
1493,644,Fri Jan 20 2017,Memphis Grizzlies,107,Sacramento Kings,91,16
644,644,Fri Jan 20 2017,Sacramento Kings,91,Memphis Grizzlies,107,-16
1494,645,Fri Jan 20 2017,New Orleans Pelicans,114,Brooklyn Nets,143,-29
645,645,Fri Jan 20 2017,Brooklyn Nets,143,New Orleans Pelicans,114,29
1495,646,Fri Jan 20 2017,Orlando Magic,112,Milwaukee Bucks,96,16
646,646,Fri Jan 20 2017,Milwaukee Bucks,96,Orlando Magic,112,-16
1496,647,Fri Jan 20 2017,Philadelphia 76ers,93,Portland Trail Blazers,92,1
647,647,Fri Jan 20 2017,Portland Trail Blazers,92,Philadelphia 76ers,93,-1
648,648,Sat Jan 21 2017,Philadelphia 76ers,93,Atlanta Hawks,110,-17
1497,648,Sat Jan 21 2017,Atlanta Hawks,110,Philadelphia 76ers,93,17
649,649,Sat Jan 21 2017,Portland Trail Blazers,127,Boston Celtics,123,4
1498,649,Sat Jan 21 2017,Boston Celtics,123,Portland Trail Blazers,127,-4
1499,650,Sat Jan 21 2017,Chicago Bulls,102,Sacramento Kings,99,3
650,650,Sat Jan 21 2017,Sacramento Kings,99,Chicago Bulls,102,-3
1500,651,Sat Jan 21 2017,Charlotte Hornets,112,Brooklyn Nets,105,7
651,651,Sat Jan 21 2017,Brooklyn Nets,105,Charlotte Hornets,112,-7
1501,652,Sat Jan 21 2017,Cleveland Cavaliers,115,San Antonio Spurs,118,-3
652,652,Sat Jan 21 2017,San Antonio Spurs,118,Cleveland Cavaliers,115,3
1502,653,Sat Jan 21 2017,Denver Nuggets,123,Los Angeles Clippers,98,25
653,653,Sat Jan 21 2017,Los Angeles Clippers,98,Denver Nuggets,123,-25
1503,654,Sat Jan 21 2017,Detroit Pistons,113,Washington Wizards,112,1
654,654,Sat Jan 21 2017,Washington Wizards,112,Detroit Pistons,113,-1
655,655,Sat Jan 21 2017,Houston Rockets,119,Memphis Grizzlies,95,24
1504,655,Sat Jan 21 2017,Memphis Grizzlies,95,Houston Rockets,119,-24
656,656,Sat Jan 21 2017,Milwaukee Bucks,97,Miami Heat,109,-12
1505,656,Sat Jan 21 2017,Miami Heat,109,Milwaukee Bucks,97,12
657,657,Sat Jan 21 2017,Phoenix Suns,107,New York Knicks,105,2
1506,657,Sat Jan 21 2017,New York Knicks,105,Phoenix Suns,107,-2
1507,658,Sat Jan 21 2017,Utah Jazz,109,Indiana Pacers,100,9
658,658,Sat Jan 21 2017,Indiana Pacers,100,Utah Jazz,109,-9
1508,659,Sun Jan 22 2017,Dallas Mavericks,122,Los Angeles Lakers,73,49
659,659,Sun Jan 22 2017,Los Angeles Lakers,73,Dallas Mavericks,122,-49
1509,660,Sun Jan 22 2017,Minnesota Timberwolves,111,Denver Nuggets,108,3
660,660,Sun Jan 22 2017,Denver Nuggets,108,Minnesota Timberwolves,111,-3
661,661,Sun Jan 22 2017,Golden State Warriors,118,Orlando Magic,98,20
1510,661,Sun Jan 22 2017,Orlando Magic,98,Golden State Warriors,118,-20
662,662,Sun Jan 22 2017,Phoenix Suns,115,Toronto Raptors,103,12
1511,662,Sun Jan 22 2017,Toronto Raptors,103,Phoenix Suns,115,-12
1512,663,Mon Jan 23 2017,Atlanta Hawks,105,Los Angeles Clippers,115,-10
663,663,Mon Jan 23 2017,Los Angeles Clippers,115,Atlanta Hawks,105,10
664,664,Mon Jan 23 2017,San Antonio Spurs,112,Brooklyn Nets,86,26
1513,664,Mon Jan 23 2017,Brooklyn Nets,86,San Antonio Spurs,112,-26
1514,665,Mon Jan 23 2017,Charlotte Hornets,99,Washington Wizards,109,-10
665,665,Mon Jan 23 2017,Washington Wizards,109,Charlotte Hornets,99,10
1515,666,Mon Jan 23 2017,Detroit Pistons,104,Sacramento Kings,109,-5
666,666,Mon Jan 23 2017,Sacramento Kings,109,Detroit Pistons,104,5
1516,667,Mon Jan 23 2017,Indiana Pacers,103,New York Knicks,109,-6
667,667,Mon Jan 23 2017,New York Knicks,109,Indiana Pacers,103,6
668,668,Mon Jan 23 2017,Golden State Warriors,102,Miami Heat,105,-3
1517,668,Mon Jan 23 2017,Miami Heat,105,Golden State Warriors,102,3
669,669,Mon Jan 23 2017,Houston Rockets,114,Milwaukee Bucks,127,-13
1518,669,Mon Jan 23 2017,Milwaukee Bucks,127,Houston Rockets,114,13
670,670,Mon Jan 23 2017,Cleveland Cavaliers,122,New Orleans Pelicans,124,-2
1519,670,Mon Jan 23 2017,New Orleans Pelicans,124,Cleveland Cavaliers,122,2
1520,671,Mon Jan 23 2017,Utah Jazz,95,Oklahoma City Thunder,97,-2
671,671,Mon Jan 23 2017,Oklahoma City Thunder,97,Utah Jazz,95,2
672,672,Tue Jan 24 2017,Utah Jazz,93,Denver Nuggets,103,-10
1521,672,Tue Jan 24 2017,Denver Nuggets,103,Utah Jazz,93,10
673,673,Tue Jan 24 2017,Chicago Bulls,100,Orlando Magic,92,8
1522,673,Tue Jan 24 2017,Orlando Magic,92,Chicago Bulls,100,-8
1523,674,Tue Jan 24 2017,Philadelphia 76ers,121,Los Angeles Clippers,110,11
674,674,Tue Jan 24 2017,Los Angeles Clippers,110,Philadelphia 76ers,121,-11
1524,675,Tue Jan 24 2017,Phoenix Suns,111,Minnesota Timberwolves,112,-1
675,675,Tue Jan 24 2017,Minnesota Timberwolves,112,Phoenix Suns,111,1
676,676,Tue Jan 24 2017,San Antonio Spurs,108,Toronto Raptors,106,2
1525,676,Tue Jan 24 2017,Toronto Raptors,106,San Antonio Spurs,108,-2
1526,677,Tue Jan 24 2017,Washington Wizards,123,Boston Celtics,108,15
677,677,Tue Jan 24 2017,Boston Celtics,108,Washington Wizards,123,-15
1527,678,Wed Jan 25 2017,Boston Celtics,120,Houston Rockets,109,11
678,678,Wed Jan 25 2017,Houston Rockets,109,Boston Celtics,120,-11
1528,679,Wed Jan 25 2017,Brooklyn Nets,106,Miami Heat,109,-3
679,679,Wed Jan 25 2017,Miami Heat,109,Brooklyn Nets,106,3
680,680,Wed Jan 25 2017,Atlanta Hawks,119,Chicago Bulls,114,5
1529,680,Wed Jan 25 2017,Chicago Bulls,114,Atlanta Hawks,119,-5
681,681,Wed Jan 25 2017,Golden State Warriors,113,Charlotte Hornets,103,10
1530,681,Wed Jan 25 2017,Charlotte Hornets,103,Golden State Warriors,113,-10
1531,682,Wed Jan 25 2017,Cleveland Cavaliers,112,Sacramento Kings,116,-4
682,682,Wed Jan 25 2017,Sacramento Kings,116,Cleveland Cavaliers,112,4
683,683,Wed Jan 25 2017,New York Knicks,95,Dallas Mavericks,103,-8
1532,683,Wed Jan 25 2017,Dallas Mavericks,103,New York Knicks,95,8
684,684,Wed Jan 25 2017,Toronto Raptors,99,Memphis Grizzlies,101,-2
1533,684,Wed Jan 25 2017,Memphis Grizzlies,101,Toronto Raptors,99,2
685,685,Wed Jan 25 2017,Philadelphia 76ers,114,Milwaukee Bucks,109,5
1534,685,Wed Jan 25 2017,Milwaukee Bucks,109,Philadelphia 76ers,114,-5
1535,686,Wed Jan 25 2017,New Orleans Pelicans,105,Oklahoma City Thunder,114,-9
686,686,Wed Jan 25 2017,Oklahoma City Thunder,114,New Orleans Pelicans,105,9
687,687,Wed Jan 25 2017,Los Angeles Lakers,98,Portland Trail Blazers,105,-7
1536,687,Wed Jan 25 2017,Portland Trail Blazers,105,Los Angeles Lakers,98,7
1537,688,Thu Jan 26 2017,Denver Nuggets,127,Phoenix Suns,120,7
688,688,Thu Jan 26 2017,Phoenix Suns,120,Denver Nuggets,127,-7
1538,689,Thu Jan 26 2017,Minnesota Timberwolves,103,Indiana Pacers,109,-6
689,689,Thu Jan 26 2017,Indiana Pacers,109,Minnesota Timberwolves,103,6
1539,690,Thu Jan 26 2017,Oklahoma City Thunder,109,Dallas Mavericks,98,11
690,690,Thu Jan 26 2017,Dallas Mavericks,98,Oklahoma City Thunder,109,-11
691,691,Thu Jan 26 2017,Los Angeles Lakers,88,Utah Jazz,96,-8
1540,691,Thu Jan 26 2017,Utah Jazz,96,Los Angeles Lakers,88,8
692,692,Fri Jan 27 2017,Washington Wizards,112,Atlanta Hawks,86,26
1541,692,Fri Jan 27 2017,Atlanta Hawks,86,Washington Wizards,112,-26
1542,693,Fri Jan 27 2017,Boston Celtics,128,Orlando Magic,98,30
693,693,Fri Jan 27 2017,Orlando Magic,98,Boston Celtics,128,-30
694,694,Fri Jan 27 2017,Miami Heat,100,Chicago Bulls,88,12
1543,694,Fri Jan 27 2017,Chicago Bulls,88,Miami Heat,100,-12
1544,695,Fri Jan 27 2017,Cleveland Cavaliers,124,Brooklyn Nets,116,8
695,695,Fri Jan 27 2017,Brooklyn Nets,116,Cleveland Cavaliers,124,-8
1545,696,Fri Jan 27 2017,Indiana Pacers,115,Sacramento Kings,111,4
696,696,Fri Jan 27 2017,Sacramento Kings,111,Indiana Pacers,115,-4
1546,697,Fri Jan 27 2017,New Orleans Pelicans,119,San Antonio Spurs,103,16
697,697,Fri Jan 27 2017,San Antonio Spurs,103,New Orleans Pelicans,119,-16
1547,698,Fri Jan 27 2017,New York Knicks,110,Charlotte Hornets,107,3
698,698,Fri Jan 27 2017,Charlotte Hornets,107,New York Knicks,110,-3
699,699,Fri Jan 27 2017,Houston Rockets,123,Philadelphia 76ers,118,5
1548,699,Fri Jan 27 2017,Philadelphia 76ers,118,Houston Rockets,123,-5
1549,700,Fri Jan 27 2017,Portland Trail Blazers,112,Memphis Grizzlies,109,3
700,700,Fri Jan 27 2017,Memphis Grizzlies,109,Portland Trail Blazers,112,-3
1550,701,Fri Jan 27 2017,Toronto Raptors,102,Milwaukee Bucks,86,16
701,701,Fri Jan 27 2017,Milwaukee Bucks,86,Toronto Raptors,102,-16
1551,702,Sat Jan 28 2017,Charlotte Hornets,106,Sacramento Kings,109,-3
702,702,Sat Jan 28 2017,Sacramento Kings,109,Charlotte Hornets,106,3
1552,703,Sat Jan 28 2017,Golden State Warriors,144,Los Angeles Clippers,98,46
703,703,Sat Jan 28 2017,Los Angeles Clippers,98,Golden State Warriors,144,-46
1553,704,Sat Jan 28 2017,Miami Heat,116,Detroit Pistons,103,13
704,704,Sat Jan 28 2017,Detroit Pistons,103,Miami Heat,116,-13
705,705,Sat Jan 28 2017,Boston Celtics,112,Milwaukee Bucks,108,4
1554,705,Sat Jan 28 2017,Milwaukee Bucks,108,Boston Celtics,112,-4
706,706,Sat Jan 28 2017,Brooklyn Nets,109,Minnesota Timberwolves,129,-20
1555,706,Sat Jan 28 2017,Minnesota Timberwolves,129,Brooklyn Nets,109,20
707,707,Sat Jan 28 2017,Denver Nuggets,123,Phoenix Suns,112,11
1556,707,Sat Jan 28 2017,Phoenix Suns,112,Denver Nuggets,123,-11
1557,708,Sat Jan 28 2017,Utah Jazz,95,Memphis Grizzlies,102,-7
708,708,Sat Jan 28 2017,Memphis Grizzlies,102,Utah Jazz,95,7
709,709,Sun Jan 29 2017,New York Knicks,139,Atlanta Hawks,142,-3
1558,709,Sun Jan 29 2017,Atlanta Hawks,142,New York Knicks,139,3
1559,710,Sun Jan 29 2017,Chicago Bulls,121,Philadelphia 76ers,108,13
710,710,Sun Jan 29 2017,Philadelphia 76ers,108,Chicago Bulls,121,-13
711,711,Sun Jan 29 2017,Oklahoma City Thunder,91,Cleveland Cavaliers,107,-16
1560,711,Sun Jan 29 2017,Cleveland Cavaliers,107,Oklahoma City Thunder,91,16
1561,712,Sun Jan 29 2017,Indiana Pacers,120,Houston Rockets,101,19
712,712,Sun Jan 29 2017,Houston Rockets,101,Indiana Pacers,120,-19
713,713,Sun Jan 29 2017,Washington Wizards,107,New Orleans Pelicans,94,13
1562,713,Sun Jan 29 2017,New Orleans Pelicans,94,Washington Wizards,107,-13
714,714,Sun Jan 29 2017,Golden State Warriors,113,Portland Trail Blazers,111,2
1563,714,Sun Jan 29 2017,Portland Trail Blazers,111,Golden State Warriors,113,-2
715,715,Sun Jan 29 2017,Dallas Mavericks,105,San Antonio Spurs,101,4
1564,715,Sun Jan 29 2017,San Antonio Spurs,101,Dallas Mavericks,105,-4
716,716,Sun Jan 29 2017,Orlando Magic,114,Toronto Raptors,113,1
1565,716,Sun Jan 29 2017,Toronto Raptors,113,Orlando Magic,114,-1
717,717,Mon Jan 30 2017,Detroit Pistons,109,Boston Celtics,113,-4
1566,717,Mon Jan 30 2017,Boston Celtics,113,Detroit Pistons,109,4
1567,718,Mon Jan 30 2017,Dallas Mavericks,104,Cleveland Cavaliers,97,7
718,718,Mon Jan 30 2017,Cleveland Cavaliers,97,Dallas Mavericks,104,-7
719,719,Mon Jan 30 2017,Brooklyn Nets,96,Miami Heat,104,-8
1568,719,Mon Jan 30 2017,Miami Heat,104,Brooklyn Nets,96,8
1569,720,Mon Jan 30 2017,Minnesota Timberwolves,111,Orlando Magic,105,6
720,720,Mon Jan 30 2017,Orlando Magic,105,Minnesota Timberwolves,111,-6
1570,721,Mon Jan 30 2017,Philadelphia 76ers,122,Sacramento Kings,119,3
721,721,Mon Jan 30 2017,Sacramento Kings,119,Philadelphia 76ers,122,-3
1571,722,Mon Jan 30 2017,Phoenix Suns,96,Memphis Grizzlies,115,-19
722,722,Mon Jan 30 2017,Memphis Grizzlies,115,Phoenix Suns,96,19
723,723,Tue Jan 31 2017,Sacramento Kings,83,Houston Rockets,105,-22
1572,723,Tue Jan 31 2017,Houston Rockets,105,Sacramento Kings,83,22
724,724,Tue Jan 31 2017,Denver Nuggets,116,Los Angeles Lakers,120,-4
1573,724,Tue Jan 31 2017,Los Angeles Lakers,120,Denver Nuggets,116,4
725,725,Tue Jan 31 2017,Charlotte Hornets,98,Portland Trail Blazers,115,-17
1574,725,Tue Jan 31 2017,Portland Trail Blazers,115,Charlotte Hornets,98,17
1575,726,Tue Jan 31 2017,San Antonio Spurs,108,Oklahoma City Thunder,94,14
726,726,Tue Jan 31 2017,Oklahoma City Thunder,94,San Antonio Spurs,108,-14
727,727,Tue Jan 31 2017,New Orleans Pelicans,106,Toronto Raptors,108,-2
1576,727,Tue Jan 31 2017,Toronto Raptors,108,New Orleans Pelicans,106,2
728,728,Tue Jan 31 2017,New York Knicks,101,Washington Wizards,117,-16
1577,728,Tue Jan 31 2017,Washington Wizards,117,New York Knicks,101,16
1578,729,Wed Feb 1 2017,Boston Celtics,109,Toronto Raptors,104,5
729,729,Wed Feb 1 2017,Toronto Raptors,104,Boston Celtics,109,-5
730,730,Wed Feb 1 2017,New York Knicks,95,Brooklyn Nets,90,5
1579,730,Wed Feb 1 2017,Brooklyn Nets,90,New York Knicks,95,-5
731,731,Wed Feb 1 2017,Minnesota Timberwolves,97,Cleveland Cavaliers,125,-28
1580,731,Wed Feb 1 2017,Cleveland Cavaliers,125,Minnesota Timberwolves,97,28
732,732,Wed Feb 1 2017,Philadelphia 76ers,95,Dallas Mavericks,113,-18
1581,732,Wed Feb 1 2017,Dallas Mavericks,113,Philadelphia 76ers,95,18
733,733,Wed Feb 1 2017,Memphis Grizzlies,119,Denver Nuggets,99,20
1582,733,Wed Feb 1 2017,Denver Nuggets,99,Memphis Grizzlies,119,-20
1583,734,Wed Feb 1 2017,Detroit Pistons,118,New Orleans Pelicans,98,20
734,734,Wed Feb 1 2017,New Orleans Pelicans,98,Detroit Pistons,118,-20
1584,735,Wed Feb 1 2017,Golden State Warriors,126,Charlotte Hornets,111,15
735,735,Wed Feb 1 2017,Charlotte Hornets,111,Golden State Warriors,126,-15
1585,736,Wed Feb 1 2017,Miami Heat,116,Atlanta Hawks,93,23
736,736,Wed Feb 1 2017,Atlanta Hawks,93,Miami Heat,116,-23
737,737,Wed Feb 1 2017,Chicago Bulls,128,Oklahoma City Thunder,100,28
1586,737,Wed Feb 1 2017,Oklahoma City Thunder,100,Chicago Bulls,128,-28
738,738,Wed Feb 1 2017,Indiana Pacers,98,Orlando Magic,88,10
1587,738,Wed Feb 1 2017,Orlando Magic,88,Indiana Pacers,98,-10
739,739,Wed Feb 1 2017,Los Angeles Clippers,124,Phoenix Suns,114,10
1588,739,Wed Feb 1 2017,Phoenix Suns,114,Los Angeles Clippers,124,-10
740,740,Wed Feb 1 2017,Milwaukee Bucks,88,Utah Jazz,104,-16
1589,740,Wed Feb 1 2017,Utah Jazz,104,Milwaukee Bucks,88,16
1590,741,Thu Feb 2 2017,Houston Rockets,108,Atlanta Hawks,113,-5
741,741,Thu Feb 2 2017,Atlanta Hawks,113,Houston Rockets,108,5
1591,742,Thu Feb 2 2017,Los Angeles Clippers,120,Golden State Warriors,133,-13
742,742,Thu Feb 2 2017,Golden State Warriors,133,Los Angeles Clippers,120,13
1592,743,Thu Feb 2 2017,San Antonio Spurs,102,Philadelphia 76ers,86,16
743,743,Thu Feb 2 2017,Philadelphia 76ers,86,San Antonio Spurs,102,-16
744,744,Thu Feb 2 2017,Los Angeles Lakers,108,Washington Wizards,116,-8
1593,744,Thu Feb 2 2017,Washington Wizards,116,Los Angeles Lakers,108,8
745,745,Fri Feb 3 2017,Los Angeles Lakers,107,Boston Celtics,113,-6
1594,745,Fri Feb 3 2017,Boston Celtics,113,Los Angeles Lakers,107,6
746,746,Fri Feb 3 2017,Indiana Pacers,106,Brooklyn Nets,97,9
1595,746,Fri Feb 3 2017,Brooklyn Nets,97,Indiana Pacers,106,-9
1596,747,Fri Feb 3 2017,Denver Nuggets,121,Milwaukee Bucks,117,4
747,747,Fri Feb 3 2017,Milwaukee Bucks,117,Denver Nuggets,121,-4
1597,748,Fri Feb 3 2017,Detroit Pistons,116,Minnesota Timberwolves,108,8
748,748,Fri Feb 3 2017,Minnesota Timberwolves,108,Detroit Pistons,116,-8
1598,749,Fri Feb 3 2017,Houston Rockets,121,Chicago Bulls,117,4
749,749,Fri Feb 3 2017,Chicago Bulls,117,Houston Rockets,121,-4
1599,750,Fri Feb 3 2017,Oklahoma City Thunder,114,Memphis Grizzlies,102,12
750,750,Fri Feb 3 2017,Memphis Grizzlies,102,Oklahoma City Thunder,114,-12
1600,751,Fri Feb 3 2017,Orlando Magic,102,Toronto Raptors,94,8
751,751,Fri Feb 3 2017,Toronto Raptors,94,Orlando Magic,102,-8
752,752,Fri Feb 3 2017,Dallas Mavericks,108,Portland Trail Blazers,104,4
1601,752,Fri Feb 3 2017,Portland Trail Blazers,104,Dallas Mavericks,108,-4
753,753,Fri Feb 3 2017,Phoenix Suns,105,Sacramento Kings,103,2
1602,753,Fri Feb 3 2017,Sacramento Kings,103,Phoenix Suns,105,-2
1603,754,Sat Feb 4 2017,Atlanta Hawks,113,Orlando Magic,86,27
754,754,Sat Feb 4 2017,Orlando Magic,86,Atlanta Hawks,113,-27
755,755,Sat Feb 4 2017,Detroit Pistons,84,Indiana Pacers,105,-21
1604,755,Sat Feb 4 2017,Indiana Pacers,105,Detroit Pistons,84,21
1605,756,Sat Feb 4 2017,Miami Heat,125,Philadelphia 76ers,102,23
756,756,Sat Feb 4 2017,Philadelphia 76ers,102,Miami Heat,125,-23
1606,757,Sat Feb 4 2017,Minnesota Timberwolves,99,Memphis Grizzlies,107,-8
757,757,Sat Feb 4 2017,Memphis Grizzlies,107,Minnesota Timberwolves,99,8
1607,758,Sat Feb 4 2017,New York Knicks,104,Cleveland Cavaliers,111,-7
758,758,Sat Feb 4 2017,Cleveland Cavaliers,111,New York Knicks,104,7
759,759,Sat Feb 4 2017,Milwaukee Bucks,137,Phoenix Suns,112,25
1608,759,Sat Feb 4 2017,Phoenix Suns,112,Milwaukee Bucks,137,-25
1609,760,Sat Feb 4 2017,Sacramento Kings,109,Golden State Warriors,106,3
760,760,Sat Feb 4 2017,Golden State Warriors,106,Sacramento Kings,109,-3
761,761,Sat Feb 4 2017,Denver Nuggets,97,San Antonio Spurs,121,-24
1610,761,Sat Feb 4 2017,San Antonio Spurs,121,Denver Nuggets,97,24
762,762,Sat Feb 4 2017,Charlotte Hornets,98,Utah Jazz,105,-7
1611,762,Sat Feb 4 2017,Utah Jazz,105,Charlotte Hornets,98,7
1612,763,Sat Feb 4 2017,Washington Wizards,105,New Orleans Pelicans,91,14
763,763,Sat Feb 4 2017,New Orleans Pelicans,91,Washington Wizards,105,-14
1613,764,Sun Feb 5 2017,Boston Celtics,107,Los Angeles Clippers,102,5
764,764,Sun Feb 5 2017,Los Angeles Clippers,102,Boston Celtics,107,-5
765,765,Sun Feb 5 2017,Toronto Raptors,103,Brooklyn Nets,95,8
1614,765,Sun Feb 5 2017,Brooklyn Nets,95,Toronto Raptors,103,-8
1615,766,Sun Feb 5 2017,Oklahoma City Thunder,105,Portland Trail Blazers,99,6
766,766,Sun Feb 5 2017,Portland Trail Blazers,99,Oklahoma City Thunder,105,-6
767,767,Mon Feb 6 2017,Utah Jazz,120,Atlanta Hawks,95,25
1616,767,Mon Feb 6 2017,Atlanta Hawks,95,Utah Jazz,120,-25
768,768,Mon Feb 6 2017,Dallas Mavericks,87,Denver Nuggets,110,-23
1617,768,Mon Feb 6 2017,Denver Nuggets,110,Dallas Mavericks,87,23
769,769,Mon Feb 6 2017,Philadelphia 76ers,96,Detroit Pistons,113,-17
1618,769,Mon Feb 6 2017,Detroit Pistons,113,Philadelphia 76ers,96,17
770,770,Mon Feb 6 2017,Oklahoma City Thunder,90,Indiana Pacers,93,-3
1619,770,Mon Feb 6 2017,Indiana Pacers,93,Oklahoma City Thunder,90,3
771,771,Mon Feb 6 2017,San Antonio Spurs,74,Memphis Grizzlies,89,-15
1620,771,Mon Feb 6 2017,Memphis Grizzlies,89,San Antonio Spurs,74,15
772,772,Mon Feb 6 2017,Miami Heat,115,Minnesota Timberwolves,113,2
1621,772,Mon Feb 6 2017,Minnesota Timberwolves,113,Miami Heat,115,-2
1622,773,Mon Feb 6 2017,New Orleans Pelicans,111,Phoenix Suns,106,5
773,773,Mon Feb 6 2017,Phoenix Suns,106,New Orleans Pelicans,111,-5
1623,774,Mon Feb 6 2017,New York Knicks,107,Los Angeles Lakers,121,-14
774,774,Mon Feb 6 2017,Los Angeles Lakers,121,New York Knicks,107,14
775,775,Mon Feb 6 2017,Chicago Bulls,112,Sacramento Kings,107,5
1624,775,Mon Feb 6 2017,Sacramento Kings,107,Chicago Bulls,112,-5
1625,776,Mon Feb 6 2017,Toronto Raptors,118,Los Angeles Clippers,109,9
776,776,Mon Feb 6 2017,Los Angeles Clippers,109,Toronto Raptors,118,-9
777,777,Mon Feb 6 2017,Cleveland Cavaliers,140,Washington Wizards,135,5
1626,777,Mon Feb 6 2017,Washington Wizards,135,Cleveland Cavaliers,140,-5
778,778,Tue Feb 7 2017,Brooklyn Nets,107,Charlotte Hornets,111,-4
1627,778,Tue Feb 7 2017,Charlotte Hornets,111,Brooklyn Nets,107,4
779,779,Tue Feb 7 2017,Portland Trail Blazers,114,Dallas Mavericks,113,1
1628,779,Tue Feb 7 2017,Dallas Mavericks,113,Portland Trail Blazers,114,-1
780,780,Tue Feb 7 2017,Orlando Magic,104,Houston Rockets,128,-24
1629,780,Tue Feb 7 2017,Houston Rockets,128,Orlando Magic,104,24
781,781,Wed Feb 8 2017,Denver Nuggets,106,Atlanta Hawks,117,-11
1630,781,Wed Feb 8 2017,Atlanta Hawks,117,Denver Nuggets,106,11
1631,782,Wed Feb 8 2017,Brooklyn Nets,110,Washington Wizards,114,-4
782,782,Wed Feb 8 2017,Washington Wizards,114,Brooklyn Nets,110,4
783,783,Wed Feb 8 2017,Los Angeles Lakers,102,Detroit Pistons,121,-19
1632,783,Wed Feb 8 2017,Detroit Pistons,121,Los Angeles Lakers,102,19
1633,784,Wed Feb 8 2017,Golden State Warriors,123,Chicago Bulls,92,31
784,784,Wed Feb 8 2017,Chicago Bulls,92,Golden State Warriors,123,-31
1634,785,Wed Feb 8 2017,Indiana Pacers,117,Cleveland Cavaliers,132,-15
785,785,Wed Feb 8 2017,Cleveland Cavaliers,132,Indiana Pacers,117,15
1635,786,Wed Feb 8 2017,Memphis Grizzlies,110,Phoenix Suns,91,19
786,786,Wed Feb 8 2017,Phoenix Suns,91,Memphis Grizzlies,110,-19
787,787,Wed Feb 8 2017,Miami Heat,106,Milwaukee Bucks,88,18
1636,787,Wed Feb 8 2017,Milwaukee Bucks,88,Miami Heat,106,-18
788,788,Wed Feb 8 2017,Toronto Raptors,109,Minnesota Timberwolves,112,-3
1637,788,Wed Feb 8 2017,Minnesota Timberwolves,112,Toronto Raptors,109,3
789,789,Wed Feb 8 2017,Utah Jazz,127,New Orleans Pelicans,94,33
1638,789,Wed Feb 8 2017,New Orleans Pelicans,94,Utah Jazz,127,-33
1639,790,Wed Feb 8 2017,New York Knicks,115,Los Angeles Clippers,119,-4
790,790,Wed Feb 8 2017,Los Angeles Clippers,119,New York Knicks,115,4
1640,791,Wed Feb 8 2017,Philadelphia 76ers,103,San Antonio Spurs,111,-8
791,791,Wed Feb 8 2017,San Antonio Spurs,111,Philadelphia 76ers,103,8
792,792,Wed Feb 8 2017,Boston Celtics,92,Sacramento Kings,108,-16
1641,792,Wed Feb 8 2017,Sacramento Kings,108,Boston Celtics,92,16
1642,793,Thu Feb 9 2017,Charlotte Hornets,95,Houston Rockets,107,-12
793,793,Thu Feb 9 2017,Houston Rockets,107,Charlotte Hornets,95,12
794,794,Thu Feb 9 2017,Utah Jazz,105,Dallas Mavericks,112,-7
1643,794,Thu Feb 9 2017,Dallas Mavericks,112,Utah Jazz,105,7
795,795,Thu Feb 9 2017,Cleveland Cavaliers,109,Oklahoma City Thunder,118,-9
1644,795,Thu Feb 9 2017,Oklahoma City Thunder,118,Cleveland Cavaliers,109,9
796,796,Thu Feb 9 2017,Philadelphia 76ers,112,Orlando Magic,111,1
1645,796,Thu Feb 9 2017,Orlando Magic,111,Philadelphia 76ers,112,-1
797,797,Thu Feb 9 2017,Boston Celtics,120,Portland Trail Blazers,111,9
1646,797,Thu Feb 9 2017,Portland Trail Blazers,111,Boston Celtics,120,-9
1647,798,Fri Feb 10 2017,Brooklyn Nets,99,Miami Heat,108,-9
798,798,Fri Feb 10 2017,Miami Heat,108,Brooklyn Nets,99,9
1648,799,Fri Feb 10 2017,Detroit Pistons,92,San Antonio Spurs,103,-11
799,799,Fri Feb 10 2017,San Antonio Spurs,103,Detroit Pistons,92,11
800,800,Fri Feb 10 2017,Golden State Warriors,122,Memphis Grizzlies,107,15
1649,800,Fri Feb 10 2017,Memphis Grizzlies,107,Golden State Warriors,122,-15
1650,801,Fri Feb 10 2017,Milwaukee Bucks,114,Los Angeles Lakers,122,-8
801,801,Fri Feb 10 2017,Los Angeles Lakers,122,Milwaukee Bucks,114,8
802,802,Fri Feb 10 2017,New Orleans Pelicans,122,Minnesota Timberwolves,106,16
1651,802,Fri Feb 10 2017,Minnesota Timberwolves,106,New Orleans Pelicans,122,-16
803,803,Fri Feb 10 2017,Denver Nuggets,131,New York Knicks,123,8
1652,803,Fri Feb 10 2017,New York Knicks,123,Denver Nuggets,131,-8
804,804,Fri Feb 10 2017,Chicago Bulls,97,Phoenix Suns,115,-18
1653,804,Fri Feb 10 2017,Phoenix Suns,115,Chicago Bulls,97,18
1654,805,Fri Feb 10 2017,Sacramento Kings,108,Atlanta Hawks,107,1
805,805,Fri Feb 10 2017,Atlanta Hawks,107,Sacramento Kings,108,-1
1655,806,Fri Feb 10 2017,Washington Wizards,112,Indiana Pacers,107,5
806,806,Fri Feb 10 2017,Indiana Pacers,107,Washington Wizards,112,-5
1656,807,Sat Feb 11 2017,Charlotte Hornets,102,Los Angeles Clippers,107,-5
807,807,Sat Feb 11 2017,Los Angeles Clippers,107,Charlotte Hornets,102,5
808,808,Sat Feb 11 2017,Denver Nuggets,109,Cleveland Cavaliers,125,-16
1657,808,Sat Feb 11 2017,Cleveland Cavaliers,125,Denver Nuggets,109,16
809,809,Sat Feb 11 2017,Orlando Magic,80,Dallas Mavericks,112,-32
1658,809,Sat Feb 11 2017,Dallas Mavericks,112,Orlando Magic,80,32
1659,810,Sat Feb 11 2017,Houston Rockets,133,Phoenix Suns,102,31
810,810,Sat Feb 11 2017,Phoenix Suns,102,Houston Rockets,133,-31
811,811,Sat Feb 11 2017,Milwaukee Bucks,116,Indiana Pacers,100,16
1660,811,Sat Feb 11 2017,Indiana Pacers,100,Milwaukee Bucks,116,-16
812,812,Sat Feb 11 2017,Golden State Warriors,130,Oklahoma City Thunder,114,16
1661,812,Sat Feb 11 2017,Oklahoma City Thunder,114,Golden State Warriors,130,-16
813,813,Sat Feb 11 2017,Miami Heat,109,Philadelphia 76ers,117,-8
1662,813,Sat Feb 11 2017,Philadelphia 76ers,117,Miami Heat,109,8
1663,814,Sat Feb 11 2017,Utah Jazz,104,Boston Celtics,112,-8
814,814,Sat Feb 11 2017,Boston Celtics,112,Utah Jazz,104,8
815,815,Sun Feb 12 2017,Chicago Bulls,89,Minnesota Timberwolves,117,-28
1664,815,Sun Feb 12 2017,Minnesota Timberwolves,117,Chicago Bulls,89,28
1665,816,Sun Feb 12 2017,New York Knicks,94,San Antonio Spurs,90,4
816,816,Sun Feb 12 2017,San Antonio Spurs,90,New York Knicks,94,-4
1666,817,Sun Feb 12 2017,Sacramento Kings,105,New Orleans Pelicans,99,6
817,817,Sun Feb 12 2017,New Orleans Pelicans,99,Sacramento Kings,105,-6
1667,818,Sun Feb 12 2017,Toronto Raptors,101,Detroit Pistons,102,-1
818,818,Sun Feb 12 2017,Detroit Pistons,102,Toronto Raptors,101,1
819,819,Mon Feb 13 2017,Memphis Grizzlies,112,Brooklyn Nets,103,9
1668,819,Mon Feb 13 2017,Brooklyn Nets,103,Memphis Grizzlies,112,-9
820,820,Mon Feb 13 2017,Philadelphia 76ers,105,Charlotte Hornets,99,6
1669,820,Mon Feb 13 2017,Charlotte Hornets,99,Philadelphia 76ers,105,-6
821,821,Mon Feb 13 2017,Boston Celtics,111,Dallas Mavericks,98,13
1670,821,Mon Feb 13 2017,Dallas Mavericks,98,Boston Celtics,111,-13
1671,822,Mon Feb 13 2017,Denver Nuggets,132,Golden State Warriors,110,22
822,822,Mon Feb 13 2017,Golden State Warriors,110,Denver Nuggets,132,-22
823,823,Mon Feb 13 2017,San Antonio Spurs,110,Indiana Pacers,106,4
1672,823,Mon Feb 13 2017,Indiana Pacers,106,San Antonio Spurs,110,-4
1673,824,Mon Feb 13 2017,Miami Heat,107,Orlando Magic,116,-9
824,824,Mon Feb 13 2017,Orlando Magic,116,Miami Heat,107,9
825,825,Mon Feb 13 2017,Detroit Pistons,89,Milwaukee Bucks,102,-13
1674,825,Mon Feb 13 2017,Milwaukee Bucks,102,Detroit Pistons,89,13
1675,826,Mon Feb 13 2017,Phoenix Suns,108,New Orleans Pelicans,110,-2
826,826,Mon Feb 13 2017,New Orleans Pelicans,110,Phoenix Suns,108,2
827,827,Mon Feb 13 2017,Atlanta Hawks,109,Portland Trail Blazers,104,5
1676,827,Mon Feb 13 2017,Portland Trail Blazers,104,Atlanta Hawks,109,-5
1677,828,Mon Feb 13 2017,Utah Jazz,72,Los Angeles Clippers,88,-16
828,828,Mon Feb 13 2017,Los Angeles Clippers,88,Utah Jazz,72,16
1678,829,Mon Feb 13 2017,Washington Wizards,120,Oklahoma City Thunder,98,22
829,829,Mon Feb 13 2017,Oklahoma City Thunder,98,Washington Wizards,120,-22
1679,830,Tue Feb 14 2017,Chicago Bulls,105,Toronto Raptors,94,11
830,830,Tue Feb 14 2017,Toronto Raptors,94,Chicago Bulls,105,-11
831,831,Tue Feb 14 2017,Sacramento Kings,97,Los Angeles Lakers,96,1
1680,831,Tue Feb 14 2017,Los Angeles Lakers,96,Sacramento Kings,97,-1
1681,832,Tue Feb 14 2017,Minnesota Timberwolves,108,Cleveland Cavaliers,116,-8
832,832,Tue Feb 14 2017,Cleveland Cavaliers,116,Minnesota Timberwolves,108,8
1682,833,Wed Feb 15 2017,Boston Celtics,116,Philadelphia 76ers,108,8
833,833,Wed Feb 15 2017,Philadelphia 76ers,108,Boston Celtics,116,-8
1683,834,Wed Feb 15 2017,Brooklyn Nets,125,Milwaukee Bucks,129,-4
834,834,Wed Feb 15 2017,Milwaukee Bucks,129,Brooklyn Nets,125,4
835,835,Wed Feb 15 2017,Indiana Pacers,104,Cleveland Cavaliers,113,-9
1684,835,Wed Feb 15 2017,Cleveland Cavaliers,113,Indiana Pacers,104,9
1685,836,Wed Feb 15 2017,Denver Nuggets,99,Minnesota Timberwolves,112,-13
836,836,Wed Feb 15 2017,Minnesota Timberwolves,112,Denver Nuggets,99,13
1686,837,Wed Feb 15 2017,Detroit Pistons,98,Dallas Mavericks,91,7
837,837,Wed Feb 15 2017,Dallas Mavericks,91,Detroit Pistons,98,-7
1687,838,Wed Feb 15 2017,Golden State Warriors,109,Sacramento Kings,86,23
838,838,Wed Feb 15 2017,Sacramento Kings,86,Golden State Warriors,109,-23
1688,839,Wed Feb 15 2017,Houston Rockets,109,Miami Heat,117,-8
839,839,Wed Feb 15 2017,Miami Heat,117,Houston Rockets,109,8
1689,840,Wed Feb 15 2017,Los Angeles Clippers,99,Atlanta Hawks,84,15
840,840,Wed Feb 15 2017,Atlanta Hawks,84,Los Angeles Clippers,99,-15
1690,841,Wed Feb 15 2017,Memphis Grizzlies,91,New Orleans Pelicans,95,-4
841,841,Wed Feb 15 2017,New Orleans Pelicans,95,Memphis Grizzlies,91,4
1691,842,Wed Feb 15 2017,Oklahoma City Thunder,116,New York Knicks,105,11
842,842,Wed Feb 15 2017,New York Knicks,105,Oklahoma City Thunder,116,-11
843,843,Wed Feb 15 2017,San Antonio Spurs,107,Orlando Magic,79,28
1692,843,Wed Feb 15 2017,Orlando Magic,79,San Antonio Spurs,107,-28
1693,844,Wed Feb 15 2017,Phoenix Suns,137,Los Angeles Lakers,101,36
844,844,Wed Feb 15 2017,Los Angeles Lakers,101,Phoenix Suns,137,-36
1694,845,Wed Feb 15 2017,Toronto Raptors,90,Charlotte Hornets,85,5
845,845,Wed Feb 15 2017,Charlotte Hornets,85,Toronto Raptors,90,-5
1695,846,Wed Feb 15 2017,Utah Jazz,111,Portland Trail Blazers,88,23
846,846,Wed Feb 15 2017,Portland Trail Blazers,88,Utah Jazz,111,-23
1696,847,Thu Feb 16 2017,Chicago Bulls,104,Boston Celtics,103,1
847,847,Thu Feb 16 2017,Boston Celtics,103,Chicago Bulls,104,-1
848,848,Thu Feb 16 2017,Washington Wizards,111,Indiana Pacers,98,13
1697,848,Thu Feb 16 2017,Indiana Pacers,98,Washington Wizards,111,-13
