,index,Date,Team1,PTS1,Team2,PTS2,MOV
0,0,Tue Oct 25 2016,New York Knicks,88,Cleveland Cavaliers,117,-29
1263,0,Tue Oct 25 2016,Cleveland Cavaliers,117,New York Knicks,88,29
1264,1,Tue Oct 25 2016,Golden State Warriors,100,San Antonio Spurs,129,-29
1,1,Tue Oct 25 2016,San Antonio Spurs,129,Golden State Warriors,100,29
2,2,Tue Oct 25 2016,Utah Jazz,104,Portland Trail Blazers,113,-9
1265,2,Tue Oct 25 2016,Portland Trail Blazers,113,Utah Jazz,104,9
3,3,Wed Oct 26 2016,Brooklyn Nets,117,Boston Celtics,122,-5
1266,3,Wed Oct 26 2016,Boston Celtics,122,Brooklyn Nets,117,5
4,4,Wed Oct 26 2016,Dallas Mavericks,121,Indiana Pacers,130,-9
1267,4,Wed Oct 26 2016,Indiana Pacers,130,Dallas Mavericks,121,9
1268,5,Wed Oct 26 2016,Los Angeles Lakers,120,Houston Rockets,114,6
5,5,Wed Oct 26 2016,Houston Rockets,114,Los Angeles Lakers,120,-6
1269,6,Wed Oct 26 2016,Memphis Grizzlies,102,Minnesota Timberwolves,98,4
6,6,Wed Oct 26 2016,Minnesota Timberwolves,98,Memphis Grizzlies,102,-4
1270,7,Wed Oct 26 2016,Milwaukee Bucks,96,Charlotte Hornets,107,-11
7,7,Wed Oct 26 2016,Charlotte Hornets,107,Milwaukee Bucks,96,11
1271,8,Wed Oct 26 2016,New Orleans Pelicans,102,Denver Nuggets,107,-5
8,8,Wed Oct 26 2016,Denver Nuggets,107,New Orleans Pelicans,102,5
1272,9,Wed Oct 26 2016,Orlando Magic,96,Miami Heat,108,-12
9,9,Wed Oct 26 2016,Miami Heat,108,Orlando Magic,96,12
1273,10,Wed Oct 26 2016,Philadelphia 76ers,97,Oklahoma City Thunder,103,-6
10,10,Wed Oct 26 2016,Oklahoma City Thunder,103,Philadelphia 76ers,97,6
1274,11,Wed Oct 26 2016,Phoenix Suns,94,Sacramento Kings,113,-19
11,11,Wed Oct 26 2016,Sacramento Kings,113,Phoenix Suns,94,19
12,12,Wed Oct 26 2016,Detroit Pistons,91,Toronto Raptors,109,-18
1275,12,Wed Oct 26 2016,Toronto Raptors,109,Detroit Pistons,91,18
13,13,Thu Oct 27 2016,Washington Wizards,99,Atlanta Hawks,114,-15
1276,13,Thu Oct 27 2016,Atlanta Hawks,114,Washington Wizards,99,15
14,14,Thu Oct 27 2016,Boston Celtics,99,Chicago Bulls,105,-6
1277,14,Thu Oct 27 2016,Chicago Bulls,105,Boston Celtics,99,6
1278,15,Thu Oct 27 2016,Portland Trail Blazers,106,Los Angeles Clippers,114,-8
15,15,Thu Oct 27 2016,Los Angeles Clippers,114,Portland Trail Blazers,106,8
16,16,Thu Oct 27 2016,San Antonio Spurs,102,Sacramento Kings,94,8
1279,16,Thu Oct 27 2016,Sacramento Kings,94,San Antonio Spurs,102,-8
17,17,Fri Oct 28 2016,Indiana Pacers,94,Brooklyn Nets,103,-9
1280,17,Fri Oct 28 2016,Brooklyn Nets,103,Indiana Pacers,94,9
18,18,Fri Oct 28 2016,Houston Rockets,106,Dallas Mavericks,98,8
1281,18,Fri Oct 28 2016,Dallas Mavericks,98,Houston Rockets,106,-8
19,19,Fri Oct 28 2016,Orlando Magic,82,Detroit Pistons,108,-26
1282,19,Fri Oct 28 2016,Detroit Pistons,108,Orlando Magic,82,26
20,20,Fri Oct 28 2016,Charlotte Hornets,97,Miami Heat,91,6
1283,20,Fri Oct 28 2016,Miami Heat,91,Charlotte Hornets,97,-6
1284,21,Fri Oct 28 2016,New Orleans Pelicans,114,Golden State Warriors,122,-8
21,21,Fri Oct 28 2016,Golden State Warriors,122,New Orleans Pelicans,114,8
22,22,Fri Oct 28 2016,Phoenix Suns,110,Oklahoma City Thunder,113,-3
1285,22,Fri Oct 28 2016,Oklahoma City Thunder,113,Phoenix Suns,110,3
1286,23,Fri Oct 28 2016,Toronto Raptors,91,Cleveland Cavaliers,94,-3
23,23,Fri Oct 28 2016,Cleveland Cavaliers,94,Toronto Raptors,91,3
24,24,Fri Oct 28 2016,Los Angeles Lakers,89,Utah Jazz,96,-7
1287,24,Fri Oct 28 2016,Utah Jazz,96,Los Angeles Lakers,89,7
25,25,Sat Oct 29 2016,Indiana Pacers,101,Chicago Bulls,118,-17
1288,25,Sat Oct 29 2016,Chicago Bulls,118,Indiana Pacers,101,17
26,26,Sat Oct 29 2016,Boston Celtics,104,Charlotte Hornets,98,6
1289,26,Sat Oct 29 2016,Charlotte Hornets,98,Boston Celtics,104,-6
1290,27,Sat Oct 29 2016,Cleveland Cavaliers,105,Orlando Magic,99,6
27,27,Sat Oct 29 2016,Orlando Magic,99,Cleveland Cavaliers,105,-6
1291,28,Sat Oct 29 2016,Denver Nuggets,113,Portland Trail Blazers,115,-2
28,28,Sat Oct 29 2016,Portland Trail Blazers,115,Denver Nuggets,113,2
29,29,Sat Oct 29 2016,Brooklyn Nets,108,Milwaukee Bucks,110,-2
1292,29,Sat Oct 29 2016,Milwaukee Bucks,110,Brooklyn Nets,108,2
1293,30,Sat Oct 29 2016,New York Knicks,111,Memphis Grizzlies,104,7
30,30,Sat Oct 29 2016,Memphis Grizzlies,104,New York Knicks,111,-7
1294,31,Sat Oct 29 2016,Philadelphia 76ers,72,Atlanta Hawks,104,-32
31,31,Sat Oct 29 2016,Atlanta Hawks,104,Philadelphia 76ers,72,32
1295,32,Sat Oct 29 2016,Sacramento Kings,106,Minnesota Timberwolves,103,3
32,32,Sat Oct 29 2016,Minnesota Timberwolves,103,Sacramento Kings,106,-3
33,33,Sat Oct 29 2016,New Orleans Pelicans,79,San Antonio Spurs,98,-19
1296,33,Sat Oct 29 2016,San Antonio Spurs,98,New Orleans Pelicans,79,19
1297,34,Sun Oct 30 2016,Detroit Pistons,98,Milwaukee Bucks,83,15
34,34,Sun Oct 30 2016,Milwaukee Bucks,83,Detroit Pistons,98,-15
1298,35,Sun Oct 30 2016,Houston Rockets,93,Dallas Mavericks,92,1
35,35,Sun Oct 30 2016,Dallas Mavericks,92,Houston Rockets,93,-1
36,36,Sun Oct 30 2016,Utah Jazz,75,Los Angeles Clippers,88,-13
1299,36,Sun Oct 30 2016,Los Angeles Clippers,88,Utah Jazz,75,13
37,37,Sun Oct 30 2016,Washington Wizards,103,Memphis Grizzlies,112,-9
1300,37,Sun Oct 30 2016,Memphis Grizzlies,112,Washington Wizards,103,9
1301,38,Sun Oct 30 2016,Miami Heat,99,San Antonio Spurs,106,-7
38,38,Sun Oct 30 2016,San Antonio Spurs,106,Miami Heat,99,7
39,39,Sun Oct 30 2016,Los Angeles Lakers,96,Oklahoma City Thunder,113,-17
1302,39,Sun Oct 30 2016,Oklahoma City Thunder,113,Los Angeles Lakers,96,17
1303,40,Sun Oct 30 2016,Phoenix Suns,100,Golden State Warriors,106,-6
40,40,Sun Oct 30 2016,Golden State Warriors,106,Phoenix Suns,100,6
41,41,Mon Oct 31 2016,Sacramento Kings,95,Atlanta Hawks,106,-11
1304,41,Mon Oct 31 2016,Atlanta Hawks,106,Sacramento Kings,95,11
42,42,Mon Oct 31 2016,Chicago Bulls,118,Brooklyn Nets,88,30
1305,42,Mon Oct 31 2016,Brooklyn Nets,88,Chicago Bulls,118,-30
43,43,Mon Oct 31 2016,Phoenix Suns,98,Los Angeles Clippers,116,-18
1306,43,Mon Oct 31 2016,Los Angeles Clippers,116,Phoenix Suns,98,18
44,44,Mon Oct 31 2016,Denver Nuggets,102,Toronto Raptors,105,-3
1307,44,Mon Oct 31 2016,Toronto Raptors,105,Denver Nuggets,102,3
45,45,Tue Nov 1 2016,Houston Rockets,120,Cleveland Cavaliers,128,-8
1308,45,Tue Nov 1 2016,Cleveland Cavaliers,128,Houston Rockets,120,8
46,46,Tue Nov 1 2016,New York Knicks,89,Detroit Pistons,102,-13
1309,46,Tue Nov 1 2016,Detroit Pistons,102,New York Knicks,89,13
47,47,Tue Nov 1 2016,Los Angeles Lakers,108,Indiana Pacers,115,-7
1310,47,Tue Nov 1 2016,Indiana Pacers,115,Los Angeles Lakers,108,7
48,48,Tue Nov 1 2016,Sacramento Kings,96,Miami Heat,108,-12
1311,48,Tue Nov 1 2016,Miami Heat,108,Sacramento Kings,96,12
1312,49,Tue Nov 1 2016,Minnesota Timberwolves,116,Memphis Grizzlies,80,36
49,49,Tue Nov 1 2016,Memphis Grizzlies,80,Minnesota Timberwolves,116,-36
1313,50,Tue Nov 1 2016,New Orleans Pelicans,113,Milwaukee Bucks,117,-4
50,50,Tue Nov 1 2016,Milwaukee Bucks,117,New Orleans Pelicans,113,4
1314,51,Tue Nov 1 2016,Philadelphia 76ers,101,Orlando Magic,103,-2
51,51,Tue Nov 1 2016,Orlando Magic,103,Philadelphia 76ers,101,2
52,52,Tue Nov 1 2016,Golden State Warriors,127,Portland Trail Blazers,104,23
1315,52,Tue Nov 1 2016,Portland Trail Blazers,104,Golden State Warriors,127,-23
53,53,Tue Nov 1 2016,Utah Jazz,106,San Antonio Spurs,91,15
1316,53,Tue Nov 1 2016,San Antonio Spurs,91,Utah Jazz,106,-15
1317,54,Wed Nov 2 2016,Atlanta Hawks,116,Los Angeles Lakers,123,-7
54,54,Wed Nov 2 2016,Los Angeles Lakers,123,Atlanta Hawks,116,7
1318,55,Wed Nov 2 2016,Boston Celtics,107,Chicago Bulls,100,7
55,55,Wed Nov 2 2016,Chicago Bulls,100,Boston Celtics,107,-7
1319,56,Wed Nov 2 2016,Brooklyn Nets,109,Detroit Pistons,101,8
56,56,Wed Nov 2 2016,Detroit Pistons,101,Brooklyn Nets,109,-8
1320,57,Wed Nov 2 2016,Charlotte Hornets,109,Philadelphia 76ers,93,16
57,57,Wed Nov 2 2016,Philadelphia 76ers,93,Charlotte Hornets,109,-16
1321,58,Wed Nov 2 2016,Los Angeles Clippers,83,Oklahoma City Thunder,85,-2
58,58,Wed Nov 2 2016,Oklahoma City Thunder,85,Los Angeles Clippers,83,2
59,59,Wed Nov 2 2016,New Orleans Pelicans,83,Memphis Grizzlies,89,-6
1322,59,Wed Nov 2 2016,Memphis Grizzlies,89,New Orleans Pelicans,83,6
60,60,Wed Nov 2 2016,Houston Rockets,118,New York Knicks,99,19
1323,60,Wed Nov 2 2016,New York Knicks,99,Houston Rockets,118,-19
61,61,Wed Nov 2 2016,Portland Trail Blazers,115,Phoenix Suns,118,-3
1324,61,Wed Nov 2 2016,Phoenix Suns,118,Portland Trail Blazers,115,3
62,62,Wed Nov 2 2016,Dallas Mavericks,81,Utah Jazz,97,-16
1325,62,Wed Nov 2 2016,Utah Jazz,97,Dallas Mavericks,81,16
63,63,Wed Nov 2 2016,Toronto Raptors,113,Washington Wizards,103,10
1326,63,Wed Nov 2 2016,Washington Wizards,103,Toronto Raptors,113,-10
64,64,Thu Nov 3 2016,Boston Celtics,122,Cleveland Cavaliers,128,-6
1327,64,Thu Nov 3 2016,Cleveland Cavaliers,128,Boston Celtics,122,6
65,65,Thu Nov 3 2016,Oklahoma City Thunder,96,Golden State Warriors,122,-26
1328,65,Thu Nov 3 2016,Golden State Warriors,122,Oklahoma City Thunder,96,26
66,66,Thu Nov 3 2016,Indiana Pacers,107,Milwaukee Bucks,125,-18
1329,66,Thu Nov 3 2016,Milwaukee Bucks,125,Indiana Pacers,107,18
67,67,Thu Nov 3 2016,Denver Nuggets,102,Minnesota Timberwolves,99,3
1330,67,Thu Nov 3 2016,Minnesota Timberwolves,99,Denver Nuggets,102,-3
68,68,Thu Nov 3 2016,Sacramento Kings,94,Orlando Magic,102,-8
1331,68,Thu Nov 3 2016,Orlando Magic,102,Sacramento Kings,94,8
69,69,Fri Nov 4 2016,Charlotte Hornets,99,Brooklyn Nets,95,4
1332,69,Fri Nov 4 2016,Brooklyn Nets,95,Charlotte Hornets,99,-4
70,70,Fri Nov 4 2016,New York Knicks,117,Chicago Bulls,104,13
1333,70,Fri Nov 4 2016,Chicago Bulls,104,New York Knicks,117,-13
71,71,Fri Nov 4 2016,Portland Trail Blazers,105,Dallas Mavericks,95,10
1334,71,Fri Nov 4 2016,Dallas Mavericks,95,Portland Trail Blazers,105,-10
72,72,Fri Nov 4 2016,Golden State Warriors,97,Los Angeles Lakers,117,-20
1335,72,Fri Nov 4 2016,Los Angeles Lakers,117,Golden State Warriors,97,20
1336,73,Fri Nov 4 2016,Memphis Grizzlies,88,Los Angeles Clippers,99,-11
73,73,Fri Nov 4 2016,Los Angeles Clippers,99,Memphis Grizzlies,88,11
1337,74,Fri Nov 4 2016,New Orleans Pelicans,111,Phoenix Suns,112,-1
74,74,Fri Nov 4 2016,Phoenix Suns,112,New Orleans Pelicans,111,1
1338,75,Fri Nov 4 2016,Toronto Raptors,96,Miami Heat,87,9
75,75,Fri Nov 4 2016,Miami Heat,87,Toronto Raptors,96,-9
1339,76,Fri Nov 4 2016,Utah Jazz,86,San Antonio Spurs,100,-14
76,76,Fri Nov 4 2016,San Antonio Spurs,100,Utah Jazz,86,14
77,77,Fri Nov 4 2016,Atlanta Hawks,92,Washington Wizards,95,-3
1340,77,Fri Nov 4 2016,Washington Wizards,95,Atlanta Hawks,92,3
78,78,Sat Nov 5 2016,Houston Rockets,97,Atlanta Hawks,112,-15
1341,78,Sat Nov 5 2016,Atlanta Hawks,112,Houston Rockets,97,15
79,79,Sat Nov 5 2016,Denver Nuggets,86,Detroit Pistons,103,-17
1342,79,Sat Nov 5 2016,Detroit Pistons,103,Denver Nuggets,86,17
80,80,Sat Nov 5 2016,Chicago Bulls,94,Indiana Pacers,111,-17
1343,80,Sat Nov 5 2016,Indiana Pacers,111,Chicago Bulls,94,17
81,81,Sat Nov 5 2016,Sacramento Kings,91,Milwaukee Bucks,117,-26
1344,81,Sat Nov 5 2016,Milwaukee Bucks,117,Sacramento Kings,91,26
82,82,Sat Nov 5 2016,Minnesota Timberwolves,92,Oklahoma City Thunder,112,-20
1345,82,Sat Nov 5 2016,Oklahoma City Thunder,112,Minnesota Timberwolves,92,20
83,83,Sat Nov 5 2016,Washington Wizards,86,Orlando Magic,88,-2
1346,83,Sat Nov 5 2016,Orlando Magic,88,Washington Wizards,86,2
84,84,Sat Nov 5 2016,Cleveland Cavaliers,102,Philadelphia 76ers,101,1
1347,84,Sat Nov 5 2016,Philadelphia 76ers,101,Cleveland Cavaliers,102,-1
85,85,Sat Nov 5 2016,Los Angeles Clippers,116,San Antonio Spurs,92,24
1348,85,Sat Nov 5 2016,San Antonio Spurs,92,Los Angeles Clippers,116,-24
1349,86,Sun Nov 6 2016,Boston Celtics,107,Denver Nuggets,123,-16
86,86,Sun Nov 6 2016,Denver Nuggets,123,Boston Celtics,107,16
87,87,Sun Nov 6 2016,Milwaukee Bucks,75,Dallas Mavericks,86,-11
1350,87,Sun Nov 6 2016,Dallas Mavericks,86,Milwaukee Bucks,75,11
88,88,Sun Nov 6 2016,Phoenix Suns,108,Los Angeles Lakers,119,-11
1351,88,Sun Nov 6 2016,Los Angeles Lakers,119,Phoenix Suns,108,11
89,89,Sun Nov 6 2016,Portland Trail Blazers,100,Memphis Grizzlies,94,6
1352,89,Sun Nov 6 2016,Memphis Grizzlies,94,Portland Trail Blazers,100,-6
90,90,Sun Nov 6 2016,Utah Jazz,114,New York Knicks,109,5
1353,90,Sun Nov 6 2016,New York Knicks,109,Utah Jazz,114,-5
1354,91,Sun Nov 6 2016,Toronto Raptors,91,Sacramento Kings,96,-5
91,91,Sun Nov 6 2016,Sacramento Kings,96,Toronto Raptors,91,5
1355,92,Mon Nov 7 2016,Chicago Bulls,112,Orlando Magic,80,32
92,92,Mon Nov 7 2016,Orlando Magic,80,Chicago Bulls,112,-32
93,93,Mon Nov 7 2016,Indiana Pacers,100,Charlotte Hornets,122,-22
1356,93,Mon Nov 7 2016,Charlotte Hornets,122,Indiana Pacers,100,22
94,94,Mon Nov 7 2016,New Orleans Pelicans,106,Golden State Warriors,116,-10
1357,94,Mon Nov 7 2016,Golden State Warriors,116,New Orleans Pelicans,106,10
1358,95,Mon Nov 7 2016,Los Angeles Clippers,114,Detroit Pistons,82,32
95,95,Mon Nov 7 2016,Detroit Pistons,82,Los Angeles Clippers,114,-32
1359,96,Mon Nov 7 2016,Oklahoma City Thunder,97,Miami Heat,85,12
96,96,Mon Nov 7 2016,Miami Heat,85,Oklahoma City Thunder,97,-12
1360,97,Mon Nov 7 2016,Philadelphia 76ers,84,Utah Jazz,109,-25
97,97,Mon Nov 7 2016,Utah Jazz,109,Philadelphia 76ers,84,25
1361,98,Mon Nov 7 2016,Washington Wizards,106,Houston Rockets,114,-8
98,98,Mon Nov 7 2016,Houston Rockets,114,Washington Wizards,106,8
1362,99,Tue Nov 8 2016,Brooklyn Nets,119,Minnesota Timberwolves,110,9
99,99,Tue Nov 8 2016,Minnesota Timberwolves,110,Brooklyn Nets,119,-9
100,100,Tue Nov 8 2016,Atlanta Hawks,110,Cleveland Cavaliers,106,4
1363,100,Tue Nov 8 2016,Cleveland Cavaliers,106,Atlanta Hawks,110,-4
101,101,Tue Nov 8 2016,Dallas Mavericks,109,Los Angeles Lakers,97,12
1364,101,Tue Nov 8 2016,Los Angeles Lakers,97,Dallas Mavericks,109,-12
1365,102,Tue Nov 8 2016,Memphis Grizzlies,108,Denver Nuggets,107,1
102,102,Tue Nov 8 2016,Denver Nuggets,107,Memphis Grizzlies,108,-1
1366,103,Tue Nov 8 2016,Portland Trail Blazers,124,Phoenix Suns,121,3
103,103,Tue Nov 8 2016,Phoenix Suns,121,Portland Trail Blazers,124,-3
104,104,Tue Nov 8 2016,New Orleans Pelicans,94,Sacramento Kings,102,-8
1367,104,Tue Nov 8 2016,Sacramento Kings,102,New Orleans Pelicans,94,8
1368,105,Wed Nov 9 2016,Atlanta Hawks,115,Chicago Bulls,107,8
105,105,Wed Nov 9 2016,Chicago Bulls,107,Atlanta Hawks,115,-8
106,106,Wed Nov 9 2016,Utah Jazz,98,Charlotte Hornets,104,-6
1369,106,Wed Nov 9 2016,Charlotte Hornets,104,Utah Jazz,98,6
1370,107,Wed Nov 9 2016,Golden State Warriors,116,Dallas Mavericks,95,21
107,107,Wed Nov 9 2016,Dallas Mavericks,95,Golden State Warriors,116,-21
1371,108,Wed Nov 9 2016,Indiana Pacers,122,Philadelphia 76ers,115,7
108,108,Wed Nov 9 2016,Philadelphia 76ers,115,Indiana Pacers,122,-7
109,109,Wed Nov 9 2016,Portland Trail Blazers,80,Los Angeles Clippers,111,-31
1372,109,Wed Nov 9 2016,Los Angeles Clippers,111,Portland Trail Blazers,80,31
110,110,Wed Nov 9 2016,Brooklyn Nets,96,New York Knicks,110,-14
1373,110,Wed Nov 9 2016,New York Knicks,110,Brooklyn Nets,96,14
111,111,Wed Nov 9 2016,Toronto Raptors,112,Oklahoma City Thunder,102,10
1374,111,Wed Nov 9 2016,Oklahoma City Thunder,102,Toronto Raptors,112,-10
112,112,Wed Nov 9 2016,Minnesota Timberwolves,123,Orlando Magic,107,16
1375,112,Wed Nov 9 2016,Orlando Magic,107,Minnesota Timberwolves,123,-16
113,113,Wed Nov 9 2016,Detroit Pistons,100,Phoenix Suns,107,-7
1376,113,Wed Nov 9 2016,Phoenix Suns,107,Detroit Pistons,100,7
114,114,Wed Nov 9 2016,Houston Rockets,101,San Antonio Spurs,99,2
1377,114,Wed Nov 9 2016,San Antonio Spurs,99,Houston Rockets,101,-2
115,115,Wed Nov 9 2016,Boston Celtics,93,Washington Wizards,118,-25
1378,115,Wed Nov 9 2016,Washington Wizards,118,Boston Celtics,93,25
116,116,Thu Nov 10 2016,Golden State Warriors,125,Denver Nuggets,101,24
1379,116,Thu Nov 10 2016,Denver Nuggets,101,Golden State Warriors,125,-24
117,117,Thu Nov 10 2016,Chicago Bulls,98,Miami Heat,95,3
1380,117,Thu Nov 10 2016,Miami Heat,95,Chicago Bulls,98,-3
118,118,Thu Nov 10 2016,New Orleans Pelicans,112,Milwaukee Bucks,106,6
1381,118,Thu Nov 10 2016,Milwaukee Bucks,106,New Orleans Pelicans,112,-6
119,119,Thu Nov 10 2016,Los Angeles Lakers,101,Sacramento Kings,91,10
1382,119,Thu Nov 10 2016,Sacramento Kings,91,Los Angeles Lakers,101,-10
120,120,Fri Nov 11 2016,New York Knicks,87,Boston Celtics,115,-28
1383,120,Fri Nov 11 2016,Boston Celtics,115,New York Knicks,87,28
121,121,Fri Nov 11 2016,Toronto Raptors,113,Charlotte Hornets,111,2
1384,121,Fri Nov 11 2016,Charlotte Hornets,111,Toronto Raptors,113,-2
122,122,Fri Nov 11 2016,Los Angeles Clippers,110,Oklahoma City Thunder,108,2
1385,122,Fri Nov 11 2016,Oklahoma City Thunder,108,Los Angeles Clippers,110,-2
123,123,Fri Nov 11 2016,Utah Jazz,87,Orlando Magic,74,13
1386,123,Fri Nov 11 2016,Orlando Magic,74,Utah Jazz,87,-13
1387,124,Fri Nov 11 2016,Philadelphia 76ers,109,Indiana Pacers,105,4
124,124,Fri Nov 11 2016,Indiana Pacers,105,Philadelphia 76ers,109,-4
125,125,Fri Nov 11 2016,Sacramento Kings,120,Portland Trail Blazers,122,-2
1388,125,Fri Nov 11 2016,Portland Trail Blazers,122,Sacramento Kings,120,2
1389,126,Fri Nov 11 2016,San Antonio Spurs,96,Detroit Pistons,86,10
126,126,Fri Nov 11 2016,Detroit Pistons,86,San Antonio Spurs,96,-10
127,127,Fri Nov 11 2016,Cleveland Cavaliers,105,Washington Wizards,94,11
1390,127,Fri Nov 11 2016,Washington Wizards,94,Cleveland Cavaliers,105,-11
1391,128,Sat Nov 12 2016,Atlanta Hawks,117,Philadelphia 76ers,96,21
128,128,Sat Nov 12 2016,Philadelphia 76ers,96,Atlanta Hawks,117,-21
129,129,Sat Nov 12 2016,Washington Wizards,95,Chicago Bulls,106,-11
1392,129,Sat Nov 12 2016,Chicago Bulls,106,Washington Wizards,95,11
130,130,Sat Nov 12 2016,Detroit Pistons,106,Denver Nuggets,95,11
1393,130,Sat Nov 12 2016,Denver Nuggets,95,Detroit Pistons,106,-11
1394,131,Sat Nov 12 2016,Houston Rockets,100,San Antonio Spurs,106,-6
131,131,Sat Nov 12 2016,San Antonio Spurs,106,Houston Rockets,100,6
1395,132,Sat Nov 12 2016,Indiana Pacers,99,Boston Celtics,105,-6
132,132,Sat Nov 12 2016,Boston Celtics,105,Indiana Pacers,99,6
133,133,Sat Nov 12 2016,Utah Jazz,102,Miami Heat,91,11
1396,133,Sat Nov 12 2016,Miami Heat,91,Utah Jazz,102,-11
134,134,Sat Nov 12 2016,Memphis Grizzlies,96,Milwaukee Bucks,106,-10
1397,134,Sat Nov 12 2016,Milwaukee Bucks,106,Memphis Grizzlies,96,10
1398,135,Sat Nov 12 2016,Minnesota Timberwolves,105,Los Angeles Clippers,119,-14
135,135,Sat Nov 12 2016,Los Angeles Clippers,119,Minnesota Timberwolves,105,14
1399,136,Sat Nov 12 2016,New Orleans Pelicans,99,Los Angeles Lakers,126,-27
136,136,Sat Nov 12 2016,Los Angeles Lakers,126,New Orleans Pelicans,99,27
1400,137,Sat Nov 12 2016,Phoenix Suns,104,Brooklyn Nets,122,-18
137,137,Sat Nov 12 2016,Brooklyn Nets,122,Phoenix Suns,104,18
1401,138,Sat Nov 12 2016,Toronto Raptors,118,New York Knicks,107,11
138,138,Sat Nov 12 2016,New York Knicks,107,Toronto Raptors,118,-11
1402,139,Sun Nov 13 2016,Cleveland Cavaliers,100,Charlotte Hornets,93,7
139,139,Sun Nov 13 2016,Charlotte Hornets,93,Cleveland Cavaliers,100,-7
1403,140,Sun Nov 13 2016,Golden State Warriors,133,Phoenix Suns,120,13
140,140,Sun Nov 13 2016,Phoenix Suns,120,Golden State Warriors,133,-13
141,141,Sun Nov 13 2016,Los Angeles Lakers,99,Minnesota Timberwolves,125,-26
1404,141,Sun Nov 13 2016,Minnesota Timberwolves,125,Los Angeles Lakers,99,26
142,142,Sun Nov 13 2016,Orlando Magic,119,Oklahoma City Thunder,117,2
1405,142,Sun Nov 13 2016,Oklahoma City Thunder,117,Orlando Magic,119,-2
1406,143,Sun Nov 13 2016,Portland Trail Blazers,112,Denver Nuggets,105,7
143,143,Sun Nov 13 2016,Denver Nuggets,105,Portland Trail Blazers,112,-7
1407,144,Mon Nov 14 2016,Detroit Pistons,104,Oklahoma City Thunder,88,16
144,144,Mon Nov 14 2016,Oklahoma City Thunder,88,Detroit Pistons,104,-16
1408,145,Mon Nov 14 2016,Houston Rockets,115,Philadelphia 76ers,88,27
145,145,Mon Nov 14 2016,Philadelphia 76ers,88,Houston Rockets,115,-27
146,146,Mon Nov 14 2016,Orlando Magic,69,Indiana Pacers,88,-19
1409,146,Mon Nov 14 2016,Indiana Pacers,88,Orlando Magic,69,19
1410,147,Mon Nov 14 2016,Los Angeles Clippers,127,Brooklyn Nets,95,32
147,147,Mon Nov 14 2016,Brooklyn Nets,95,Los Angeles Clippers,127,-32
148,148,Mon Nov 14 2016,Boston Celtics,105,New Orleans Pelicans,106,-1
1411,148,Mon Nov 14 2016,New Orleans Pelicans,106,Boston Celtics,105,1
1412,149,Mon Nov 14 2016,New York Knicks,93,Dallas Mavericks,77,16
149,149,Mon Nov 14 2016,Dallas Mavericks,77,New York Knicks,93,-16
1413,150,Mon Nov 14 2016,San Antonio Spurs,94,Miami Heat,90,4
150,150,Mon Nov 14 2016,Miami Heat,90,San Antonio Spurs,94,-4
151,151,Mon Nov 14 2016,Memphis Grizzlies,102,Utah Jazz,96,6
1414,151,Mon Nov 14 2016,Utah Jazz,96,Memphis Grizzlies,102,-6
152,152,Tue Nov 15 2016,Toronto Raptors,117,Cleveland Cavaliers,121,-4
1415,152,Tue Nov 15 2016,Cleveland Cavaliers,121,Toronto Raptors,117,4
153,153,Tue Nov 15 2016,Brooklyn Nets,118,Los Angeles Lakers,125,-7
1416,153,Tue Nov 15 2016,Los Angeles Lakers,125,Brooklyn Nets,118,7
154,154,Tue Nov 15 2016,Atlanta Hawks,93,Miami Heat,90,3
1417,154,Tue Nov 15 2016,Miami Heat,90,Atlanta Hawks,93,-3
1418,155,Tue Nov 15 2016,Minnesota Timberwolves,108,Charlotte Hornets,115,-7
155,155,Tue Nov 15 2016,Charlotte Hornets,115,Minnesota Timberwolves,108,7
156,156,Tue Nov 15 2016,Chicago Bulls,113,Portland Trail Blazers,88,25
1419,156,Tue Nov 15 2016,Portland Trail Blazers,88,Chicago Bulls,113,-25
1420,157,Wed Nov 16 2016,Atlanta Hawks,107,Milwaukee Bucks,100,7
157,157,Wed Nov 16 2016,Milwaukee Bucks,100,Atlanta Hawks,107,-7
1421,158,Wed Nov 16 2016,Boston Celtics,90,Dallas Mavericks,83,7
158,158,Wed Nov 16 2016,Dallas Mavericks,83,Boston Celtics,90,-7
1422,159,Wed Nov 16 2016,Denver Nuggets,120,Phoenix Suns,104,16
159,159,Wed Nov 16 2016,Phoenix Suns,104,Denver Nuggets,120,-16
160,160,Wed Nov 16 2016,Cleveland Cavaliers,93,Indiana Pacers,103,-10
1423,160,Wed Nov 16 2016,Indiana Pacers,103,Cleveland Cavaliers,93,10
1424,161,Wed Nov 16 2016,Los Angeles Clippers,107,Memphis Grizzlies,111,-4
161,161,Wed Nov 16 2016,Memphis Grizzlies,111,Los Angeles Clippers,107,4
162,162,Wed Nov 16 2016,Detroit Pistons,102,New York Knicks,105,-3
1425,162,Wed Nov 16 2016,New York Knicks,105,Detroit Pistons,102,3
163,163,Wed Nov 16 2016,Houston Rockets,103,Oklahoma City Thunder,105,-2
1426,163,Wed Nov 16 2016,Oklahoma City Thunder,105,Houston Rockets,103,2
164,164,Wed Nov 16 2016,New Orleans Pelicans,82,Orlando Magic,89,-7
1427,164,Wed Nov 16 2016,Orlando Magic,89,New Orleans Pelicans,82,7
165,165,Wed Nov 16 2016,Washington Wizards,102,Philadelphia 76ers,109,-7
1428,165,Wed Nov 16 2016,Philadelphia 76ers,109,Washington Wizards,102,7
166,166,Wed Nov 16 2016,San Antonio Spurs,110,Sacramento Kings,105,5
1429,166,Wed Nov 16 2016,Sacramento Kings,105,San Antonio Spurs,110,-5
167,167,Wed Nov 16 2016,Golden State Warriors,127,Toronto Raptors,121,6
1430,167,Wed Nov 16 2016,Toronto Raptors,121,Golden State Warriors,127,-6
168,168,Thu Nov 17 2016,Portland Trail Blazers,109,Houston Rockets,126,-17
1431,168,Thu Nov 17 2016,Houston Rockets,126,Portland Trail Blazers,109,17
1432,169,Thu Nov 17 2016,Miami Heat,96,Milwaukee Bucks,73,23
169,169,Thu Nov 17 2016,Milwaukee Bucks,73,Miami Heat,96,-23
1433,170,Thu Nov 17 2016,Minnesota Timberwolves,110,Philadelphia 76ers,86,24
170,170,Thu Nov 17 2016,Philadelphia 76ers,86,Minnesota Timberwolves,110,-24
1434,171,Thu Nov 17 2016,Utah Jazz,77,Chicago Bulls,85,-8
171,171,Thu Nov 17 2016,Chicago Bulls,85,Utah Jazz,77,8
1435,172,Thu Nov 17 2016,Washington Wizards,119,New York Knicks,112,7
172,172,Thu Nov 17 2016,New York Knicks,112,Washington Wizards,119,-7
1436,173,Fri Nov 18 2016,Boston Celtics,88,Golden State Warriors,104,-16
173,173,Fri Nov 18 2016,Golden State Warriors,104,Boston Celtics,88,16
1437,174,Fri Nov 18 2016,Charlotte Hornets,100,Atlanta Hawks,96,4
174,174,Fri Nov 18 2016,Atlanta Hawks,96,Charlotte Hornets,100,-4
1438,175,Fri Nov 18 2016,Cleveland Cavaliers,104,Detroit Pistons,81,23
175,175,Fri Nov 18 2016,Detroit Pistons,81,Cleveland Cavaliers,104,-23
1439,176,Fri Nov 18 2016,Dallas Mavericks,64,Memphis Grizzlies,80,-16
176,176,Fri Nov 18 2016,Memphis Grizzlies,80,Dallas Mavericks,64,16
1440,177,Fri Nov 18 2016,Denver Nuggets,111,Toronto Raptors,113,-2
177,177,Fri Nov 18 2016,Toronto Raptors,113,Denver Nuggets,111,2
1441,178,Fri Nov 18 2016,Indiana Pacers,96,Phoenix Suns,116,-20
178,178,Fri Nov 18 2016,Phoenix Suns,116,Indiana Pacers,96,20
1442,179,Fri Nov 18 2016,Los Angeles Lakers,107,San Antonio Spurs,116,-9
179,179,Fri Nov 18 2016,San Antonio Spurs,116,Los Angeles Lakers,107,9
180,180,Fri Nov 18 2016,Portland Trail Blazers,101,New Orleans Pelicans,113,-12
1443,180,Fri Nov 18 2016,New Orleans Pelicans,113,Portland Trail Blazers,101,12
181,181,Fri Nov 18 2016,Brooklyn Nets,105,Oklahoma City Thunder,124,-19
1444,181,Fri Nov 18 2016,Oklahoma City Thunder,124,Brooklyn Nets,105,19
182,182,Fri Nov 18 2016,Los Angeles Clippers,121,Sacramento Kings,115,6
1445,182,Fri Nov 18 2016,Sacramento Kings,115,Los Angeles Clippers,121,-6
183,183,Sat Nov 19 2016,Boston Celtics,94,Detroit Pistons,92,2
1446,183,Sat Nov 19 2016,Detroit Pistons,92,Boston Celtics,94,-2
184,184,Sat Nov 19 2016,Utah Jazz,102,Houston Rockets,111,-9
1447,184,Sat Nov 19 2016,Houston Rockets,111,Utah Jazz,102,9
185,185,Sat Nov 19 2016,Chicago Bulls,95,Los Angeles Clippers,102,-7
1448,185,Sat Nov 19 2016,Los Angeles Clippers,102,Chicago Bulls,95,7
186,186,Sat Nov 19 2016,Minnesota Timberwolves,71,Memphis Grizzlies,93,-22
1449,186,Sat Nov 19 2016,Memphis Grizzlies,93,Minnesota Timberwolves,71,22
1450,187,Sat Nov 19 2016,Milwaukee Bucks,121,Golden State Warriors,124,-3
187,187,Sat Nov 19 2016,Golden State Warriors,124,Milwaukee Bucks,121,3
1451,188,Sat Nov 19 2016,New Orleans Pelicans,121,Charlotte Hornets,116,5
188,188,Sat Nov 19 2016,Charlotte Hornets,116,New Orleans Pelicans,121,-5
189,189,Sat Nov 19 2016,Dallas Mavericks,87,Orlando Magic,95,-8
1452,189,Sat Nov 19 2016,Orlando Magic,95,Dallas Mavericks,87,8
1453,190,Sat Nov 19 2016,Philadelphia 76ers,120,Phoenix Suns,105,15
190,190,Sat Nov 19 2016,Phoenix Suns,105,Philadelphia 76ers,120,-15
191,191,Sat Nov 19 2016,Miami Heat,114,Washington Wizards,111,3
1454,191,Sat Nov 19 2016,Washington Wizards,111,Miami Heat,114,-3
192,192,Sun Nov 20 2016,Portland Trail Blazers,129,Brooklyn Nets,109,20
1455,192,Sun Nov 20 2016,Brooklyn Nets,109,Portland Trail Blazers,129,-20
1456,193,Sun Nov 20 2016,Denver Nuggets,105,Utah Jazz,91,14
193,193,Sun Nov 20 2016,Utah Jazz,91,Denver Nuggets,105,-14
194,194,Sun Nov 20 2016,Chicago Bulls,118,Los Angeles Lakers,110,8
1457,194,Sun Nov 20 2016,Los Angeles Lakers,110,Chicago Bulls,118,-8
195,195,Sun Nov 20 2016,Atlanta Hawks,94,New York Knicks,104,-10
1458,195,Sun Nov 20 2016,New York Knicks,104,Atlanta Hawks,94,10
1459,196,Sun Nov 20 2016,Oklahoma City Thunder,111,Indiana Pacers,115,-4
196,196,Sun Nov 20 2016,Indiana Pacers,115,Oklahoma City Thunder,111,4
197,197,Sun Nov 20 2016,Toronto Raptors,99,Sacramento Kings,102,-3
1460,197,Sun Nov 20 2016,Sacramento Kings,102,Toronto Raptors,99,3
1461,198,Mon Nov 21 2016,Charlotte Hornets,90,Memphis Grizzlies,105,-15
198,198,Mon Nov 21 2016,Memphis Grizzlies,105,Charlotte Hornets,90,15
1462,199,Mon Nov 21 2016,Detroit Pistons,96,Houston Rockets,99,-3
199,199,Mon Nov 21 2016,Houston Rockets,99,Detroit Pistons,96,3
1463,200,Mon Nov 21 2016,Indiana Pacers,83,Golden State Warriors,120,-37
200,200,Mon Nov 21 2016,Golden State Warriors,120,Indiana Pacers,83,37
1464,201,Mon Nov 21 2016,Los Angeles Clippers,123,Toronto Raptors,115,8
201,201,Mon Nov 21 2016,Toronto Raptors,115,Los Angeles Clippers,123,-8
202,202,Mon Nov 21 2016,Orlando Magic,89,Milwaukee Bucks,93,-4
1465,202,Mon Nov 21 2016,Milwaukee Bucks,93,Orlando Magic,89,4
203,203,Mon Nov 21 2016,Boston Celtics,99,Minnesota Timberwolves,93,6
1466,203,Mon Nov 21 2016,Minnesota Timberwolves,93,Boston Celtics,99,-6
204,204,Mon Nov 21 2016,Miami Heat,94,Philadelphia 76ers,101,-7
1467,204,Mon Nov 21 2016,Philadelphia 76ers,101,Miami Heat,94,7
205,205,Mon Nov 21 2016,Dallas Mavericks,91,San Antonio Spurs,96,-5
1468,205,Mon Nov 21 2016,San Antonio Spurs,96,Dallas Mavericks,91,5
206,206,Mon Nov 21 2016,Phoenix Suns,101,Washington Wizards,106,-5
1469,206,Mon Nov 21 2016,Washington Wizards,106,Phoenix Suns,101,5
1470,207,Tue Nov 22 2016,Atlanta Hawks,94,New Orleans Pelicans,112,-18
207,207,Tue Nov 22 2016,New Orleans Pelicans,112,Atlanta Hawks,94,18
1471,208,Tue Nov 22 2016,Denver Nuggets,110,Chicago Bulls,107,3
208,208,Tue Nov 22 2016,Chicago Bulls,107,Denver Nuggets,110,-3
1472,209,Tue Nov 22 2016,Los Angeles Lakers,111,Oklahoma City Thunder,109,2
209,209,Tue Nov 22 2016,Oklahoma City Thunder,109,Los Angeles Lakers,111,-2
1473,210,Tue Nov 22 2016,New York Knicks,107,Portland Trail Blazers,103,4
210,210,Tue Nov 22 2016,Portland Trail Blazers,103,New York Knicks,107,-4
1474,211,Wed Nov 23 2016,Brooklyn Nets,92,Boston Celtics,111,-19
211,211,Wed Nov 23 2016,Boston Celtics,111,Brooklyn Nets,92,19
1475,212,Wed Nov 23 2016,Charlotte Hornets,114,San Antonio Spurs,119,-5
212,212,Wed Nov 23 2016,San Antonio Spurs,119,Charlotte Hornets,114,5
1476,213,Wed Nov 23 2016,Cleveland Cavaliers,137,Portland Trail Blazers,125,12
213,213,Wed Nov 23 2016,Portland Trail Blazers,125,Cleveland Cavaliers,137,-12
1477,214,Wed Nov 23 2016,Dallas Mavericks,104,Los Angeles Clippers,124,-20
214,214,Wed Nov 23 2016,Los Angeles Clippers,124,Dallas Mavericks,104,20
215,215,Wed Nov 23 2016,Miami Heat,84,Detroit Pistons,107,-23
1478,215,Wed Nov 23 2016,Detroit Pistons,107,Miami Heat,84,23
216,216,Wed Nov 23 2016,Los Angeles Lakers,106,Golden State Warriors,149,-43
1479,216,Wed Nov 23 2016,Golden State Warriors,149,Los Angeles Lakers,106,43
1480,217,Wed Nov 23 2016,Houston Rockets,102,Toronto Raptors,115,-13
217,217,Wed Nov 23 2016,Toronto Raptors,115,Houston Rockets,102,13
218,218,Wed Nov 23 2016,Atlanta Hawks,96,Indiana Pacers,85,11
1481,218,Wed Nov 23 2016,Indiana Pacers,85,Atlanta Hawks,96,-11
219,219,Wed Nov 23 2016,Minnesota Timberwolves,96,New Orleans Pelicans,117,-21
1482,219,Wed Nov 23 2016,New Orleans Pelicans,117,Minnesota Timberwolves,96,21
220,220,Wed Nov 23 2016,Phoenix Suns,92,Orlando Magic,87,5
1483,220,Wed Nov 23 2016,Orlando Magic,87,Phoenix Suns,92,-5
1484,221,Wed Nov 23 2016,Philadelphia 76ers,99,Memphis Grizzlies,104,-5
221,221,Wed Nov 23 2016,Memphis Grizzlies,104,Philadelphia 76ers,99,5
1485,222,Wed Nov 23 2016,Sacramento Kings,116,Oklahoma City Thunder,101,15
222,222,Wed Nov 23 2016,Oklahoma City Thunder,101,Sacramento Kings,116,-15
1486,223,Wed Nov 23 2016,Utah Jazz,108,Denver Nuggets,83,25
223,223,Wed Nov 23 2016,Denver Nuggets,83,Utah Jazz,108,-25
224,224,Fri Nov 25 2016,San Antonio Spurs,109,Boston Celtics,103,6
1487,224,Fri Nov 25 2016,Boston Celtics,103,San Antonio Spurs,109,-6
1488,225,Fri Nov 25 2016,Cleveland Cavaliers,128,Dallas Mavericks,90,38
225,225,Fri Nov 25 2016,Dallas Mavericks,90,Cleveland Cavaliers,128,-38
1489,226,Fri Nov 25 2016,Denver Nuggets,129,Oklahoma City Thunder,132,-3
226,226,Fri Nov 25 2016,Oklahoma City Thunder,132,Denver Nuggets,129,3
227,227,Fri Nov 25 2016,Los Angeles Clippers,97,Detroit Pistons,108,-11
1490,227,Fri Nov 25 2016,Detroit Pistons,108,Los Angeles Clippers,97,11
1491,228,Fri Nov 25 2016,Indiana Pacers,118,Brooklyn Nets,97,21
228,228,Fri Nov 25 2016,Brooklyn Nets,97,Indiana Pacers,118,-21
1492,229,Fri Nov 25 2016,Los Angeles Lakers,85,Golden State Warriors,109,-24
229,229,Fri Nov 25 2016,Golden State Warriors,109,Los Angeles Lakers,85,24
230,230,Fri Nov 25 2016,Miami Heat,90,Memphis Grizzlies,81,9
1493,230,Fri Nov 25 2016,Memphis Grizzlies,81,Miami Heat,90,-9
1494,231,Fri Nov 25 2016,Milwaukee Bucks,99,Toronto Raptors,105,-6
231,231,Fri Nov 25 2016,Toronto Raptors,105,Milwaukee Bucks,99,6
232,232,Fri Nov 25 2016,Charlotte Hornets,111,New York Knicks,113,-2
1495,232,Fri Nov 25 2016,New York Knicks,113,Charlotte Hornets,111,2
1496,233,Fri Nov 25 2016,Orlando Magic,91,Washington Wizards,94,-3
233,233,Fri Nov 25 2016,Washington Wizards,94,Orlando Magic,91,3
234,234,Fri Nov 25 2016,Chicago Bulls,105,Philadelphia 76ers,89,16
1497,234,Fri Nov 25 2016,Philadelphia 76ers,89,Chicago Bulls,105,-16
1498,235,Fri Nov 25 2016,Phoenix Suns,85,Minnesota Timberwolves,98,-13
235,235,Fri Nov 25 2016,Minnesota Timberwolves,98,Phoenix Suns,85,13
1499,236,Fri Nov 25 2016,Portland Trail Blazers,119,New Orleans Pelicans,104,15
236,236,Fri Nov 25 2016,New Orleans Pelicans,104,Portland Trail Blazers,119,-15
237,237,Fri Nov 25 2016,Houston Rockets,117,Sacramento Kings,104,13
1500,237,Fri Nov 25 2016,Sacramento Kings,104,Houston Rockets,117,-13
1501,238,Fri Nov 25 2016,Utah Jazz,95,Atlanta Hawks,68,27
238,238,Fri Nov 25 2016,Atlanta Hawks,68,Utah Jazz,95,-27
239,239,Sat Nov 26 2016,New York Knicks,102,Charlotte Hornets,107,-5
1502,239,Sat Nov 26 2016,Charlotte Hornets,107,New York Knicks,102,5
1503,240,Sat Nov 26 2016,Golden State Warriors,115,Minnesota Timberwolves,102,13
240,240,Sat Nov 26 2016,Minnesota Timberwolves,102,Golden State Warriors,115,-13
1504,241,Sat Nov 26 2016,Miami Heat,107,Memphis Grizzlies,110,-3
241,241,Sat Nov 26 2016,Memphis Grizzlies,110,Miami Heat,107,3
1505,242,Sat Nov 26 2016,Oklahoma City Thunder,106,Detroit Pistons,88,18
242,242,Sat Nov 26 2016,Detroit Pistons,88,Oklahoma City Thunder,106,-18
1506,243,Sat Nov 26 2016,Washington Wizards,100,San Antonio Spurs,112,-12
243,243,Sat Nov 26 2016,San Antonio Spurs,112,Washington Wizards,100,12
1507,244,Sun Nov 27 2016,Brooklyn Nets,105,Sacramento Kings,122,-17
244,244,Sun Nov 27 2016,Sacramento Kings,122,Brooklyn Nets,105,17
1508,245,Sun Nov 27 2016,Dallas Mavericks,91,New Orleans Pelicans,81,10
245,245,Sun Nov 27 2016,New Orleans Pelicans,81,Dallas Mavericks,91,-10
1509,246,Sun Nov 27 2016,Indiana Pacers,91,Los Angeles Clippers,70,21
246,246,Sun Nov 27 2016,Los Angeles Clippers,70,Indiana Pacers,91,-21
1510,247,Sun Nov 27 2016,Los Angeles Lakers,109,Atlanta Hawks,94,15
247,247,Sun Nov 27 2016,Atlanta Hawks,94,Los Angeles Lakers,109,-15
248,248,Sun Nov 27 2016,Milwaukee Bucks,104,Orlando Magic,96,8
1511,248,Sun Nov 27 2016,Orlando Magic,96,Milwaukee Bucks,104,-8
249,249,Sun Nov 27 2016,Cleveland Cavaliers,112,Philadelphia 76ers,108,4
1512,249,Sun Nov 27 2016,Philadelphia 76ers,108,Cleveland Cavaliers,112,-4
250,250,Sun Nov 27 2016,Denver Nuggets,120,Phoenix Suns,114,6
1513,250,Sun Nov 27 2016,Phoenix Suns,114,Denver Nuggets,120,-6
251,251,Sun Nov 27 2016,Houston Rockets,130,Portland Trail Blazers,114,16
1514,251,Sun Nov 27 2016,Portland Trail Blazers,114,Houston Rockets,130,-16
252,252,Mon Nov 28 2016,Atlanta Hawks,100,Golden State Warriors,105,-5
1515,252,Mon Nov 28 2016,Golden State Warriors,105,Atlanta Hawks,100,5
1516,253,Mon Nov 28 2016,Memphis Grizzlies,85,Charlotte Hornets,104,-19
253,253,Mon Nov 28 2016,Charlotte Hornets,104,Memphis Grizzlies,85,19
254,254,Mon Nov 28 2016,Boston Celtics,112,Miami Heat,104,8
1517,254,Mon Nov 28 2016,Miami Heat,104,Boston Celtics,112,-8
1518,255,Mon Nov 28 2016,Minnesota Timberwolves,103,Utah Jazz,112,-9
255,255,Mon Nov 28 2016,Utah Jazz,112,Minnesota Timberwolves,103,9
256,256,Mon Nov 28 2016,Oklahoma City Thunder,112,New York Knicks,103,9
1519,256,Mon Nov 28 2016,New York Knicks,103,Oklahoma City Thunder,112,-9
257,257,Mon Nov 28 2016,Philadelphia 76ers,95,Toronto Raptors,122,-27
1520,257,Mon Nov 28 2016,Toronto Raptors,122,Philadelphia 76ers,95,27
1521,258,Mon Nov 28 2016,Washington Wizards,101,Sacramento Kings,95,6
258,258,Mon Nov 28 2016,Sacramento Kings,95,Washington Wizards,101,-6
259,259,Tue Nov 29 2016,Los Angeles Clippers,122,Brooklyn Nets,127,-5
1522,259,Tue Nov 29 2016,Brooklyn Nets,127,Los Angeles Clippers,122,5
260,260,Tue Nov 29 2016,Detroit Pistons,112,Charlotte Hornets,89,23
1523,260,Tue Nov 29 2016,Charlotte Hornets,89,Detroit Pistons,112,-23
261,261,Tue Nov 29 2016,Cleveland Cavaliers,101,Milwaukee Bucks,118,-17
1524,261,Tue Nov 29 2016,Milwaukee Bucks,118,Cleveland Cavaliers,101,17
262,262,Tue Nov 29 2016,Los Angeles Lakers,88,New Orleans Pelicans,105,-17
1525,262,Tue Nov 29 2016,New Orleans Pelicans,105,Los Angeles Lakers,88,17
263,263,Tue Nov 29 2016,Orlando Magic,95,San Antonio Spurs,83,12
1526,263,Tue Nov 29 2016,San Antonio Spurs,83,Orlando Magic,95,-12
1527,264,Tue Nov 29 2016,Utah Jazz,120,Houston Rockets,101,19
264,264,Tue Nov 29 2016,Houston Rockets,101,Utah Jazz,120,-19
1528,265,Wed Nov 30 2016,Boston Celtics,114,Detroit Pistons,121,-7
265,265,Wed Nov 30 2016,Detroit Pistons,121,Boston Celtics,114,7
1529,266,Wed Nov 30 2016,Chicago Bulls,90,Los Angeles Lakers,96,-6
266,266,Wed Nov 30 2016,Los Angeles Lakers,96,Chicago Bulls,90,6
1530,267,Wed Nov 30 2016,Dallas Mavericks,87,San Antonio Spurs,94,-7
267,267,Wed Nov 30 2016,San Antonio Spurs,94,Dallas Mavericks,87,7
268,268,Wed Nov 30 2016,Miami Heat,106,Denver Nuggets,98,8
1531,268,Wed Nov 30 2016,Denver Nuggets,98,Miami Heat,106,-8
1532,269,Wed Nov 30 2016,Minnesota Timberwolves,104,New York Knicks,106,-2
269,269,Wed Nov 30 2016,New York Knicks,106,Minnesota Timberwolves,104,2
1533,270,Wed Nov 30 2016,Oklahoma City Thunder,126,Washington Wizards,115,11
270,270,Wed Nov 30 2016,Washington Wizards,115,Oklahoma City Thunder,126,-11
271,271,Wed Nov 30 2016,Atlanta Hawks,107,Phoenix Suns,109,-2
1534,271,Wed Nov 30 2016,Phoenix Suns,109,Atlanta Hawks,107,2
272,272,Wed Nov 30 2016,Indiana Pacers,109,Portland Trail Blazers,131,-22
1535,272,Wed Nov 30 2016,Portland Trail Blazers,131,Indiana Pacers,109,22
273,273,Wed Nov 30 2016,Memphis Grizzlies,105,Toronto Raptors,120,-15
1536,273,Wed Nov 30 2016,Toronto Raptors,120,Memphis Grizzlies,105,15
274,274,Thu Dec 1 2016,Milwaukee Bucks,111,Brooklyn Nets,93,18
1537,274,Thu Dec 1 2016,Brooklyn Nets,93,Milwaukee Bucks,111,-18
275,275,Thu Dec 1 2016,Dallas Mavericks,87,Charlotte Hornets,97,-10
1538,275,Thu Dec 1 2016,Charlotte Hornets,97,Dallas Mavericks,87,10
1539,276,Thu Dec 1 2016,Cleveland Cavaliers,94,Los Angeles Clippers,113,-19
276,276,Thu Dec 1 2016,Los Angeles Clippers,113,Cleveland Cavaliers,94,19
1540,277,Thu Dec 1 2016,Golden State Warriors,127,Houston Rockets,132,-5
277,277,Thu Dec 1 2016,Houston Rockets,132,Golden State Warriors,127,5
1541,278,Thu Dec 1 2016,Memphis Grizzlies,95,Orlando Magic,94,1
278,278,Thu Dec 1 2016,Orlando Magic,94,Memphis Grizzlies,95,-1
1542,279,Thu Dec 1 2016,Utah Jazz,110,Miami Heat,111,-1
279,279,Thu Dec 1 2016,Miami Heat,111,Utah Jazz,110,1
1543,280,Fri Dec 2 2016,Atlanta Hawks,85,Detroit Pistons,121,-36
280,280,Fri Dec 2 2016,Detroit Pistons,121,Atlanta Hawks,85,36
281,281,Fri Dec 2 2016,Sacramento Kings,92,Boston Celtics,97,-5
1544,281,Fri Dec 2 2016,Boston Celtics,97,Sacramento Kings,92,5
282,282,Fri Dec 2 2016,Cleveland Cavaliers,105,Chicago Bulls,111,-6
1545,282,Fri Dec 2 2016,Chicago Bulls,111,Cleveland Cavaliers,105,6
1546,283,Fri Dec 2 2016,Denver Nuggets,110,Houston Rockets,128,-18
283,283,Fri Dec 2 2016,Houston Rockets,128,Denver Nuggets,110,18
1547,284,Fri Dec 2 2016,New Orleans Pelicans,96,Los Angeles Clippers,114,-18
284,284,Fri Dec 2 2016,Los Angeles Clippers,114,New Orleans Pelicans,96,18
285,285,Fri Dec 2 2016,Minnesota Timberwolves,114,New York Knicks,118,-4
1548,285,Fri Dec 2 2016,New York Knicks,118,Minnesota Timberwolves,114,4
286,286,Fri Dec 2 2016,Orlando Magic,105,Philadelphia 76ers,88,17
1549,286,Fri Dec 2 2016,Philadelphia 76ers,88,Orlando Magic,105,-17
1550,287,Fri Dec 2 2016,San Antonio Spurs,107,Washington Wizards,105,2
287,287,Fri Dec 2 2016,Washington Wizards,105,San Antonio Spurs,107,-2
1551,288,Fri Dec 2 2016,Toronto Raptors,113,Los Angeles Lakers,80,33
288,288,Fri Dec 2 2016,Los Angeles Lakers,80,Toronto Raptors,113,-33
1552,289,Sat Dec 3 2016,Charlotte Hornets,120,Minnesota Timberwolves,125,-5
289,289,Sat Dec 3 2016,Minnesota Timberwolves,125,Charlotte Hornets,120,5
1553,290,Sat Dec 3 2016,Dallas Mavericks,107,Chicago Bulls,82,25
290,290,Sat Dec 3 2016,Chicago Bulls,82,Dallas Mavericks,107,-25
291,291,Sat Dec 3 2016,Phoenix Suns,109,Golden State Warriors,138,-29
1554,291,Sat Dec 3 2016,Golden State Warriors,138,Phoenix Suns,109,29
1555,292,Sat Dec 3 2016,Memphis Grizzlies,103,Los Angeles Lakers,100,3
292,292,Sat Dec 3 2016,Los Angeles Lakers,100,Memphis Grizzlies,103,-3
1556,293,Sat Dec 3 2016,Milwaukee Bucks,112,Brooklyn Nets,103,9
293,293,Sat Dec 3 2016,Brooklyn Nets,103,Milwaukee Bucks,112,-9
1557,294,Sat Dec 3 2016,Philadelphia 76ers,106,Boston Celtics,107,-1
294,294,Sat Dec 3 2016,Boston Celtics,107,Philadelphia 76ers,106,1
1558,295,Sat Dec 3 2016,Portland Trail Blazers,99,Miami Heat,92,7
295,295,Sat Dec 3 2016,Miami Heat,92,Portland Trail Blazers,99,-7
296,296,Sat Dec 3 2016,Atlanta Hawks,84,Toronto Raptors,128,-44
1559,296,Sat Dec 3 2016,Toronto Raptors,128,Atlanta Hawks,84,44
297,297,Sat Dec 3 2016,Denver Nuggets,98,Utah Jazz,105,-7
1560,297,Sat Dec 3 2016,Utah Jazz,105,Denver Nuggets,98,7
1561,298,Sun Dec 4 2016,Detroit Pistons,92,Orlando Magic,98,-6
298,298,Sun Dec 4 2016,Orlando Magic,98,Detroit Pistons,92,6
1562,299,Sun Dec 4 2016,Los Angeles Clippers,102,Indiana Pacers,111,-9
299,299,Sun Dec 4 2016,Indiana Pacers,111,Los Angeles Clippers,102,9
300,300,Sun Dec 4 2016,Sacramento Kings,98,New York Knicks,106,-8
1563,300,Sun Dec 4 2016,New York Knicks,106,Sacramento Kings,98,8
301,301,Sun Dec 4 2016,New Orleans Pelicans,92,Oklahoma City Thunder,101,-9
1564,301,Sun Dec 4 2016,Oklahoma City Thunder,101,New Orleans Pelicans,92,9
302,302,Mon Dec 5 2016,Oklahoma City Thunder,102,Atlanta Hawks,99,3
1565,302,Mon Dec 5 2016,Atlanta Hawks,99,Oklahoma City Thunder,102,-3
1566,303,Mon Dec 5 2016,Brooklyn Nets,113,Washington Wizards,118,-5
303,303,Mon Dec 5 2016,Washington Wizards,118,Brooklyn Nets,113,5
1567,304,Mon Dec 5 2016,Chicago Bulls,110,Portland Trail Blazers,112,-2
304,304,Mon Dec 5 2016,Portland Trail Blazers,112,Chicago Bulls,110,2
305,305,Mon Dec 5 2016,Charlotte Hornets,109,Dallas Mavericks,101,8
1568,305,Mon Dec 5 2016,Dallas Mavericks,101,Charlotte Hornets,109,-8
306,306,Mon Dec 5 2016,Indiana Pacers,106,Golden State Warriors,142,-36
1569,306,Mon Dec 5 2016,Golden State Warriors,142,Indiana Pacers,106,36
1570,307,Mon Dec 5 2016,Houston Rockets,107,Boston Celtics,106,1
307,307,Mon Dec 5 2016,Boston Celtics,106,Houston Rockets,107,-1
1571,308,Mon Dec 5 2016,Los Angeles Lakers,101,Utah Jazz,107,-6
308,308,Mon Dec 5 2016,Utah Jazz,107,Los Angeles Lakers,101,6
1572,309,Mon Dec 5 2016,Milwaukee Bucks,96,San Antonio Spurs,97,-1
309,309,Mon Dec 5 2016,San Antonio Spurs,97,Milwaukee Bucks,96,1
310,310,Mon Dec 5 2016,Memphis Grizzlies,110,New Orleans Pelicans,108,2
1573,310,Mon Dec 5 2016,New Orleans Pelicans,108,Memphis Grizzlies,110,-2
311,311,Mon Dec 5 2016,Denver Nuggets,106,Philadelphia 76ers,98,8
1574,311,Mon Dec 5 2016,Philadelphia 76ers,98,Denver Nuggets,106,-8
312,312,Mon Dec 5 2016,Cleveland Cavaliers,116,Toronto Raptors,112,4
1575,312,Mon Dec 5 2016,Toronto Raptors,112,Cleveland Cavaliers,116,-4
1576,313,Tue Dec 6 2016,Detroit Pistons,102,Chicago Bulls,91,11
313,313,Tue Dec 6 2016,Chicago Bulls,91,Detroit Pistons,102,-11
314,314,Tue Dec 6 2016,Philadelphia 76ers,91,Memphis Grizzlies,96,-5
1577,314,Tue Dec 6 2016,Memphis Grizzlies,96,Philadelphia 76ers,91,5
315,315,Tue Dec 6 2016,New York Knicks,114,Miami Heat,103,11
1578,315,Tue Dec 6 2016,Miami Heat,103,New York Knicks,114,-11
316,316,Tue Dec 6 2016,San Antonio Spurs,105,Minnesota Timberwolves,91,14
1579,316,Tue Dec 6 2016,Minnesota Timberwolves,91,San Antonio Spurs,105,-14
317,317,Tue Dec 6 2016,Phoenix Suns,105,Utah Jazz,112,-7
1580,317,Tue Dec 6 2016,Utah Jazz,112,Phoenix Suns,105,7
318,318,Tue Dec 6 2016,Orlando Magic,124,Washington Wizards,116,8
1581,318,Tue Dec 6 2016,Washington Wizards,116,Orlando Magic,124,-8
1582,319,Wed Dec 7 2016,Atlanta Hawks,103,Miami Heat,95,8
319,319,Wed Dec 7 2016,Miami Heat,95,Atlanta Hawks,103,-8
320,320,Wed Dec 7 2016,Denver Nuggets,111,Brooklyn Nets,116,-5
1583,320,Wed Dec 7 2016,Brooklyn Nets,116,Denver Nuggets,111,5
321,321,Wed Dec 7 2016,Detroit Pistons,77,Charlotte Hornets,87,-10
1584,321,Wed Dec 7 2016,Charlotte Hornets,87,Detroit Pistons,77,10
1585,322,Wed Dec 7 2016,Dallas Mavericks,89,Sacramento Kings,120,-31
322,322,Wed Dec 7 2016,Sacramento Kings,120,Dallas Mavericks,89,31
1586,323,Wed Dec 7 2016,Houston Rockets,134,Los Angeles Lakers,95,39
323,323,Wed Dec 7 2016,Los Angeles Lakers,95,Houston Rockets,134,-39
1587,324,Wed Dec 7 2016,Los Angeles Clippers,98,Golden State Warriors,115,-17
324,324,Wed Dec 7 2016,Golden State Warriors,115,Los Angeles Clippers,98,17
325,325,Wed Dec 7 2016,Portland Trail Blazers,107,Milwaukee Bucks,115,-8
1588,325,Wed Dec 7 2016,Milwaukee Bucks,115,Portland Trail Blazers,107,8
326,326,Wed Dec 7 2016,Cleveland Cavaliers,126,New York Knicks,94,32
1589,326,Wed Dec 7 2016,New York Knicks,94,Cleveland Cavaliers,126,-32
1590,327,Wed Dec 7 2016,Orlando Magic,87,Boston Celtics,117,-30
327,327,Wed Dec 7 2016,Boston Celtics,117,Orlando Magic,87,30
1591,328,Wed Dec 7 2016,Phoenix Suns,94,Indiana Pacers,109,-15
328,328,Wed Dec 7 2016,Indiana Pacers,109,Phoenix Suns,94,15
1592,329,Thu Dec 8 2016,Chicago Bulls,95,San Antonio Spurs,91,4
329,329,Thu Dec 8 2016,San Antonio Spurs,91,Chicago Bulls,95,-4
1593,330,Thu Dec 8 2016,Memphis Grizzlies,88,Portland Trail Blazers,86,2
330,330,Thu Dec 8 2016,Portland Trail Blazers,86,Memphis Grizzlies,88,-2
1594,331,Thu Dec 8 2016,New Orleans Pelicans,88,Philadelphia 76ers,99,-11
331,331,Thu Dec 8 2016,Philadelphia 76ers,99,New Orleans Pelicans,88,11
332,332,Thu Dec 8 2016,Minnesota Timberwolves,110,Toronto Raptors,124,-14
1595,332,Thu Dec 8 2016,Toronto Raptors,124,Minnesota Timberwolves,110,14
1596,333,Thu Dec 8 2016,Utah Jazz,99,Golden State Warriors,106,-7
333,333,Thu Dec 8 2016,Golden State Warriors,106,Utah Jazz,99,7
1597,334,Thu Dec 8 2016,Washington Wizards,92,Denver Nuggets,85,7
334,334,Thu Dec 8 2016,Denver Nuggets,85,Washington Wizards,92,-7
1598,335,Fri Dec 9 2016,Boston Celtics,94,Toronto Raptors,101,-7
335,335,Fri Dec 9 2016,Toronto Raptors,101,Boston Celtics,94,7
336,336,Fri Dec 9 2016,Orlando Magic,88,Charlotte Hornets,109,-21
1599,336,Fri Dec 9 2016,Charlotte Hornets,109,Orlando Magic,88,21
337,337,Fri Dec 9 2016,Miami Heat,84,Cleveland Cavaliers,114,-30
1600,337,Fri Dec 9 2016,Cleveland Cavaliers,114,Miami Heat,84,30
1601,338,Fri Dec 9 2016,Dallas Mavericks,111,Indiana Pacers,103,8
338,338,Fri Dec 9 2016,Indiana Pacers,103,Dallas Mavericks,111,-8
1602,339,Fri Dec 9 2016,Los Angeles Lakers,115,Phoenix Suns,119,-4
339,339,Fri Dec 9 2016,Phoenix Suns,119,Los Angeles Lakers,115,4
1603,340,Fri Dec 9 2016,Milwaukee Bucks,110,Atlanta Hawks,114,-4
340,340,Fri Dec 9 2016,Atlanta Hawks,114,Milwaukee Bucks,110,4
341,341,Fri Dec 9 2016,Detroit Pistons,117,Minnesota Timberwolves,90,27
1604,341,Fri Dec 9 2016,Minnesota Timberwolves,90,Detroit Pistons,117,-27
1605,342,Fri Dec 9 2016,Oklahoma City Thunder,99,Houston Rockets,102,-3
342,342,Fri Dec 9 2016,Houston Rockets,102,Oklahoma City Thunder,99,3
1606,343,Fri Dec 9 2016,Sacramento Kings,100,New York Knicks,103,-3
343,343,Fri Dec 9 2016,New York Knicks,103,Sacramento Kings,100,3
1607,344,Sat Dec 10 2016,Chicago Bulls,105,Miami Heat,100,5
344,344,Sat Dec 10 2016,Miami Heat,100,Chicago Bulls,105,-5
1608,345,Sat Dec 10 2016,Cleveland Cavaliers,116,Charlotte Hornets,105,11
345,345,Sat Dec 10 2016,Charlotte Hornets,105,Cleveland Cavaliers,116,-11
1609,346,Sat Dec 10 2016,Houston Rockets,109,Dallas Mavericks,87,22
346,346,Sat Dec 10 2016,Dallas Mavericks,87,Houston Rockets,109,-22
1610,347,Sat Dec 10 2016,Indiana Pacers,118,Portland Trail Blazers,111,7
347,347,Sat Dec 10 2016,Portland Trail Blazers,111,Indiana Pacers,118,-7
1611,348,Sat Dec 10 2016,Los Angeles Clippers,133,New Orleans Pelicans,105,28
348,348,Sat Dec 10 2016,New Orleans Pelicans,105,Los Angeles Clippers,133,-28
349,349,Sat Dec 10 2016,Golden State Warriors,89,Memphis Grizzlies,110,-21
1612,349,Sat Dec 10 2016,Memphis Grizzlies,110,Golden State Warriors,89,21
350,350,Sat Dec 10 2016,Denver Nuggets,121,Orlando Magic,113,8
1613,350,Sat Dec 10 2016,Orlando Magic,113,Denver Nuggets,121,-8
351,351,Sat Dec 10 2016,Brooklyn Nets,101,San Antonio Spurs,130,-29
1614,351,Sat Dec 10 2016,San Antonio Spurs,130,Brooklyn Nets,101,29
352,352,Sat Dec 10 2016,Sacramento Kings,84,Utah Jazz,104,-20
1615,352,Sat Dec 10 2016,Utah Jazz,104,Sacramento Kings,84,20
353,353,Sat Dec 10 2016,Milwaukee Bucks,105,Washington Wizards,110,-5
1616,353,Sat Dec 10 2016,Washington Wizards,110,Milwaukee Bucks,105,5
1617,354,Sun Dec 11 2016,Detroit Pistons,79,Philadelphia 76ers,97,-18
354,354,Sun Dec 11 2016,Philadelphia 76ers,97,Detroit Pistons,79,18
1618,355,Sun Dec 11 2016,Los Angeles Lakers,112,New York Knicks,118,-6
355,355,Sun Dec 11 2016,New York Knicks,118,Los Angeles Lakers,112,6
356,356,Sun Dec 11 2016,Golden State Warriors,116,Minnesota Timberwolves,108,8
1619,356,Sun Dec 11 2016,Minnesota Timberwolves,108,Golden State Warriors,116,-8
1620,357,Sun Dec 11 2016,Oklahoma City Thunder,99,Boston Celtics,96,3
357,357,Sun Dec 11 2016,Boston Celtics,96,Oklahoma City Thunder,99,-3
1621,358,Sun Dec 11 2016,Phoenix Suns,119,New Orleans Pelicans,120,-1
358,358,Sun Dec 11 2016,New Orleans Pelicans,120,Phoenix Suns,119,1
1622,359,Mon Dec 12 2016,Dallas Mavericks,112,Denver Nuggets,92,20
359,359,Mon Dec 12 2016,Denver Nuggets,92,Dallas Mavericks,112,-20
1623,360,Mon Dec 12 2016,Houston Rockets,122,Brooklyn Nets,118,4
360,360,Mon Dec 12 2016,Brooklyn Nets,118,Houston Rockets,122,-4
1624,361,Mon Dec 12 2016,Indiana Pacers,110,Charlotte Hornets,94,16
361,361,Mon Dec 12 2016,Charlotte Hornets,94,Indiana Pacers,110,-16
362,362,Mon Dec 12 2016,Portland Trail Blazers,120,Los Angeles Clippers,121,-1
1625,362,Mon Dec 12 2016,Los Angeles Clippers,121,Portland Trail Blazers,120,1
1626,363,Mon Dec 12 2016,Miami Heat,112,Washington Wizards,101,11
363,363,Mon Dec 12 2016,Washington Wizards,101,Miami Heat,112,-11
1627,364,Mon Dec 12 2016,Sacramento Kings,116,Los Angeles Lakers,92,24
364,364,Mon Dec 12 2016,Los Angeles Lakers,92,Sacramento Kings,116,-24
1628,365,Mon Dec 12 2016,Toronto Raptors,122,Milwaukee Bucks,100,22
365,365,Mon Dec 12 2016,Milwaukee Bucks,100,Toronto Raptors,122,-22
366,366,Tue Dec 13 2016,Orlando Magic,131,Atlanta Hawks,120,11
1629,366,Tue Dec 13 2016,Atlanta Hawks,120,Orlando Magic,131,-11
1630,367,Tue Dec 13 2016,Chicago Bulls,94,Minnesota Timberwolves,99,-5
367,367,Tue Dec 13 2016,Minnesota Timberwolves,99,Chicago Bulls,94,5
1631,368,Tue Dec 13 2016,Cleveland Cavaliers,103,Memphis Grizzlies,86,17
368,368,Tue Dec 13 2016,Memphis Grizzlies,86,Cleveland Cavaliers,103,-17
1632,369,Tue Dec 13 2016,New Orleans Pelicans,109,Golden State Warriors,113,-4
369,369,Tue Dec 13 2016,Golden State Warriors,113,New Orleans Pelicans,109,4
1633,370,Tue Dec 13 2016,Phoenix Suns,113,New York Knicks,111,2
370,370,Tue Dec 13 2016,New York Knicks,111,Phoenix Suns,113,-2
1634,371,Tue Dec 13 2016,Portland Trail Blazers,114,Oklahoma City Thunder,95,19
371,371,Tue Dec 13 2016,Oklahoma City Thunder,95,Portland Trail Blazers,114,-19
1635,372,Wed Dec 14 2016,Brooklyn Nets,107,Los Angeles Lakers,97,10
372,372,Wed Dec 14 2016,Los Angeles Lakers,97,Brooklyn Nets,107,-10
1636,373,Wed Dec 14 2016,Dallas Mavericks,85,Detroit Pistons,95,-10
373,373,Wed Dec 14 2016,Detroit Pistons,95,Dallas Mavericks,85,10
1637,374,Wed Dec 14 2016,Houston Rockets,132,Sacramento Kings,98,34
374,374,Wed Dec 14 2016,Sacramento Kings,98,Houston Rockets,132,-34
1638,375,Wed Dec 14 2016,Memphis Grizzlies,93,Cleveland Cavaliers,85,8
375,375,Wed Dec 14 2016,Cleveland Cavaliers,85,Memphis Grizzlies,93,-8
376,376,Wed Dec 14 2016,Indiana Pacers,89,Miami Heat,95,-6
1639,376,Wed Dec 14 2016,Miami Heat,95,Indiana Pacers,89,6
1640,377,Wed Dec 14 2016,Orlando Magic,108,Los Angeles Clippers,113,-5
377,377,Wed Dec 14 2016,Los Angeles Clippers,113,Orlando Magic,108,5
378,378,Wed Dec 14 2016,Toronto Raptors,123,Philadelphia 76ers,114,9
1641,378,Wed Dec 14 2016,Philadelphia 76ers,114,Toronto Raptors,123,-9
379,379,Wed Dec 14 2016,Boston Celtics,101,San Antonio Spurs,108,-7
1642,379,Wed Dec 14 2016,San Antonio Spurs,108,Boston Celtics,101,7
380,380,Wed Dec 14 2016,Oklahoma City Thunder,89,Utah Jazz,109,-20
1643,380,Wed Dec 14 2016,Utah Jazz,109,Oklahoma City Thunder,89,20
1644,381,Wed Dec 14 2016,Washington Wizards,109,Charlotte Hornets,106,3
381,381,Wed Dec 14 2016,Charlotte Hornets,106,Washington Wizards,109,-3
1645,382,Thu Dec 15 2016,Denver Nuggets,132,Portland Trail Blazers,120,12
382,382,Thu Dec 15 2016,Portland Trail Blazers,120,Denver Nuggets,132,-12
383,383,Thu Dec 15 2016,New York Knicks,90,Golden State Warriors,103,-13
1646,383,Thu Dec 15 2016,Golden State Warriors,103,New York Knicks,90,13
1647,384,Thu Dec 15 2016,Milwaukee Bucks,108,Chicago Bulls,97,11
384,384,Thu Dec 15 2016,Chicago Bulls,97,Milwaukee Bucks,108,-11
1648,385,Thu Dec 15 2016,New Orleans Pelicans,102,Indiana Pacers,95,7
385,385,Thu Dec 15 2016,Indiana Pacers,95,New Orleans Pelicans,102,-7
1649,386,Thu Dec 15 2016,Phoenix Suns,92,San Antonio Spurs,107,-15
386,386,Thu Dec 15 2016,San Antonio Spurs,107,Phoenix Suns,92,15
387,387,Fri Dec 16 2016,Charlotte Hornets,88,Boston Celtics,96,-8
1650,387,Fri Dec 16 2016,Boston Celtics,96,Charlotte Hornets,88,8
1651,388,Fri Dec 16 2016,Chicago Bulls,69,Milwaukee Bucks,95,-26
388,388,Fri Dec 16 2016,Milwaukee Bucks,95,Chicago Bulls,69,26
389,389,Fri Dec 16 2016,New Orleans Pelicans,100,Houston Rockets,122,-22
1652,389,Fri Dec 16 2016,Houston Rockets,122,New Orleans Pelicans,100,22
390,390,Fri Dec 16 2016,Sacramento Kings,96,Memphis Grizzlies,92,4
1653,390,Fri Dec 16 2016,Memphis Grizzlies,92,Sacramento Kings,96,-4
391,391,Fri Dec 16 2016,Los Angeles Clippers,102,Miami Heat,98,4
1654,391,Fri Dec 16 2016,Miami Heat,98,Los Angeles Clippers,102,-4
392,392,Fri Dec 16 2016,Brooklyn Nets,111,Orlando Magic,118,-7
1655,392,Fri Dec 16 2016,Orlando Magic,118,Brooklyn Nets,111,7
1656,393,Fri Dec 16 2016,Philadelphia 76ers,89,Los Angeles Lakers,100,-11
393,393,Fri Dec 16 2016,Los Angeles Lakers,100,Philadelphia 76ers,89,11
394,394,Fri Dec 16 2016,Atlanta Hawks,125,Toronto Raptors,121,4
1657,394,Fri Dec 16 2016,Toronto Raptors,121,Atlanta Hawks,125,-4
395,395,Fri Dec 16 2016,Dallas Mavericks,100,Utah Jazz,103,-3
1658,395,Fri Dec 16 2016,Utah Jazz,103,Dallas Mavericks,100,3
396,396,Fri Dec 16 2016,Detroit Pistons,108,Washington Wizards,122,-14
1659,396,Fri Dec 16 2016,Washington Wizards,122,Detroit Pistons,108,14
397,397,Sat Dec 17 2016,Charlotte Hornets,107,Atlanta Hawks,99,8
1660,397,Sat Dec 17 2016,Atlanta Hawks,99,Charlotte Hornets,107,-8
398,398,Sat Dec 17 2016,Los Angeles Lakers,108,Cleveland Cavaliers,119,-11
1661,398,Sat Dec 17 2016,Cleveland Cavaliers,119,Los Angeles Lakers,108,11
399,399,Sat Dec 17 2016,New York Knicks,114,Denver Nuggets,127,-13
1662,399,Sat Dec 17 2016,Denver Nuggets,127,New York Knicks,114,13
400,400,Sat Dec 17 2016,Indiana Pacers,105,Detroit Pistons,90,15
1663,400,Sat Dec 17 2016,Detroit Pistons,90,Indiana Pacers,105,-15
401,401,Sat Dec 17 2016,Portland Trail Blazers,90,Golden State Warriors,135,-45
1664,401,Sat Dec 17 2016,Golden State Warriors,135,Portland Trail Blazers,90,45
402,402,Sat Dec 17 2016,Houston Rockets,111,Minnesota Timberwolves,109,2
1665,402,Sat Dec 17 2016,Minnesota Timberwolves,109,Houston Rockets,111,-2
403,403,Sat Dec 17 2016,Phoenix Suns,101,Oklahoma City Thunder,114,-13
1666,403,Sat Dec 17 2016,Oklahoma City Thunder,114,Phoenix Suns,101,13
404,404,Sun Dec 18 2016,Sacramento Kings,79,Dallas Mavericks,99,-20
1667,404,Sun Dec 18 2016,Dallas Mavericks,99,Sacramento Kings,79,20
405,405,Sun Dec 18 2016,Utah Jazz,82,Memphis Grizzlies,73,9
1668,405,Sun Dec 18 2016,Memphis Grizzlies,73,Utah Jazz,82,-9
406,406,Sun Dec 18 2016,Boston Celtics,105,Miami Heat,95,10
1669,406,Sun Dec 18 2016,Miami Heat,95,Boston Celtics,105,-10
407,407,Sun Dec 18 2016,Toronto Raptors,109,Orlando Magic,79,30
1670,407,Sun Dec 18 2016,Orlando Magic,79,Toronto Raptors,109,-30
1671,408,Sun Dec 18 2016,Philadelphia 76ers,108,Brooklyn Nets,107,1
408,408,Sun Dec 18 2016,Brooklyn Nets,107,Philadelphia 76ers,108,-1
409,409,Sun Dec 18 2016,New Orleans Pelicans,100,San Antonio Spurs,113,-13
1672,409,Sun Dec 18 2016,San Antonio Spurs,113,New Orleans Pelicans,100,13
410,410,Sun Dec 18 2016,Los Angeles Clippers,110,Washington Wizards,117,-7
1673,410,Sun Dec 18 2016,Washington Wizards,117,Los Angeles Clippers,110,7
411,411,Mon Dec 19 2016,Detroit Pistons,82,Chicago Bulls,113,-31
1674,411,Mon Dec 19 2016,Chicago Bulls,113,Detroit Pistons,82,31
1675,412,Mon Dec 19 2016,Denver Nuggets,117,Dallas Mavericks,107,10
412,412,Mon Dec 19 2016,Dallas Mavericks,107,Denver Nuggets,117,-10
1676,413,Mon Dec 19 2016,Indiana Pacers,107,Washington Wizards,105,2
413,413,Mon Dec 19 2016,Washington Wizards,105,Indiana Pacers,107,-2
1677,414,Mon Dec 19 2016,Minnesota Timberwolves,115,Phoenix Suns,108,7
414,414,Mon Dec 19 2016,Phoenix Suns,108,Minnesota Timberwolves,115,-7
415,415,Mon Dec 19 2016,Atlanta Hawks,110,Oklahoma City Thunder,108,2
1678,415,Mon Dec 19 2016,Oklahoma City Thunder,108,Atlanta Hawks,110,-2
416,416,Tue Dec 20 2016,Los Angeles Lakers,113,Charlotte Hornets,117,-4
1679,416,Tue Dec 20 2016,Charlotte Hornets,117,Los Angeles Lakers,113,4
1680,417,Tue Dec 20 2016,Golden State Warriors,104,Utah Jazz,74,30
417,417,Tue Dec 20 2016,Utah Jazz,74,Golden State Warriors,104,-30
1681,418,Tue Dec 20 2016,Houston Rockets,100,San Antonio Spurs,102,-2
418,418,Tue Dec 20 2016,San Antonio Spurs,102,Houston Rockets,100,2
1682,419,Tue Dec 20 2016,Los Angeles Clippers,119,Denver Nuggets,102,17
419,419,Tue Dec 20 2016,Denver Nuggets,102,Los Angeles Clippers,119,-17
1683,420,Tue Dec 20 2016,Memphis Grizzlies,109,Boston Celtics,112,-3
420,420,Tue Dec 20 2016,Boston Celtics,112,Memphis Grizzlies,109,3
421,421,Tue Dec 20 2016,Orlando Magic,136,Miami Heat,130,6
1684,421,Tue Dec 20 2016,Miami Heat,130,Orlando Magic,136,-6
1685,422,Tue Dec 20 2016,Milwaukee Bucks,108,Cleveland Cavaliers,114,-6
422,422,Tue Dec 20 2016,Cleveland Cavaliers,114,Milwaukee Bucks,108,6
423,423,Tue Dec 20 2016,Indiana Pacers,111,New York Knicks,118,-7
1686,423,Tue Dec 20 2016,New York Knicks,118,Indiana Pacers,111,7
1687,424,Tue Dec 20 2016,Philadelphia 76ers,93,New Orleans Pelicans,108,-15
424,424,Tue Dec 20 2016,New Orleans Pelicans,108,Philadelphia 76ers,93,15
425,425,Tue Dec 20 2016,Portland Trail Blazers,121,Sacramento Kings,126,-5
1688,425,Tue Dec 20 2016,Sacramento Kings,126,Portland Trail Blazers,121,5
1689,426,Tue Dec 20 2016,Toronto Raptors,116,Brooklyn Nets,104,12
426,426,Tue Dec 20 2016,Brooklyn Nets,104,Toronto Raptors,116,-12
427,427,Wed Dec 21 2016,Minnesota Timberwolves,92,Atlanta Hawks,84,8
1690,427,Wed Dec 21 2016,Atlanta Hawks,84,Minnesota Timberwolves,92,-8
428,428,Wed Dec 21 2016,Washington Wizards,107,Chicago Bulls,97,10
1691,428,Wed Dec 21 2016,Chicago Bulls,97,Washington Wizards,107,-10
1692,429,Wed Dec 21 2016,Cleveland Cavaliers,113,Milwaukee Bucks,102,11
429,429,Wed Dec 21 2016,Milwaukee Bucks,102,Cleveland Cavaliers,113,-11
1693,430,Wed Dec 21 2016,Detroit Pistons,86,Memphis Grizzlies,98,-12
430,430,Wed Dec 21 2016,Memphis Grizzlies,98,Detroit Pistons,86,12
1694,431,Wed Dec 21 2016,New Orleans Pelicans,110,Oklahoma City Thunder,121,-11
431,431,Wed Dec 21 2016,Oklahoma City Thunder,121,New Orleans Pelicans,110,11
1695,432,Wed Dec 21 2016,Phoenix Suns,111,Houston Rockets,125,-14
432,432,Wed Dec 21 2016,Houston Rockets,125,Phoenix Suns,111,14
1696,433,Wed Dec 21 2016,Portland Trail Blazers,95,Dallas Mavericks,96,-1
433,433,Wed Dec 21 2016,Dallas Mavericks,96,Portland Trail Blazers,95,1
434,434,Wed Dec 21 2016,Sacramento Kings,94,Utah Jazz,93,1
1697,434,Wed Dec 21 2016,Utah Jazz,93,Sacramento Kings,94,-1
1698,435,Thu Dec 22 2016,Brooklyn Nets,101,Golden State Warriors,117,-16
435,435,Thu Dec 22 2016,Golden State Warriors,117,Brooklyn Nets,101,16
1699,436,Thu Dec 22 2016,Indiana Pacers,102,Boston Celtics,109,-7
436,436,Thu Dec 22 2016,Boston Celtics,109,Indiana Pacers,102,7
1700,437,Thu Dec 22 2016,Los Angeles Clippers,106,San Antonio Spurs,101,5
437,437,Thu Dec 22 2016,San Antonio Spurs,101,Los Angeles Clippers,106,-5
1701,438,Thu Dec 22 2016,Miami Heat,115,Los Angeles Lakers,107,8
438,438,Thu Dec 22 2016,Los Angeles Lakers,107,Miami Heat,115,-8
1702,439,Thu Dec 22 2016,New York Knicks,106,Orlando Magic,95,11
439,439,Thu Dec 22 2016,Orlando Magic,95,New York Knicks,106,-11
440,440,Fri Dec 23 2016,Oklahoma City Thunder,117,Boston Celtics,112,5
1703,440,Fri Dec 23 2016,Boston Celtics,112,Oklahoma City Thunder,117,-5
441,441,Fri Dec 23 2016,Chicago Bulls,91,Charlotte Hornets,103,-12
1704,441,Fri Dec 23 2016,Charlotte Hornets,103,Chicago Bulls,91,12
1705,442,Fri Dec 23 2016,Cleveland Cavaliers,119,Brooklyn Nets,99,20
442,442,Fri Dec 23 2016,Brooklyn Nets,99,Cleveland Cavaliers,119,-20
1706,443,Fri Dec 23 2016,Denver Nuggets,108,Atlanta Hawks,109,-1
443,443,Fri Dec 23 2016,Atlanta Hawks,109,Denver Nuggets,108,1
444,444,Fri Dec 23 2016,Golden State Warriors,119,Detroit Pistons,113,6
1707,444,Fri Dec 23 2016,Detroit Pistons,113,Golden State Warriors,119,-6
445,445,Fri Dec 23 2016,Dallas Mavericks,90,Los Angeles Clippers,88,2
1708,445,Fri Dec 23 2016,Los Angeles Clippers,88,Dallas Mavericks,90,-2
446,446,Fri Dec 23 2016,Houston Rockets,109,Memphis Grizzlies,115,-6
1709,446,Fri Dec 23 2016,Memphis Grizzlies,115,Houston Rockets,109,6
1710,447,Fri Dec 23 2016,Milwaukee Bucks,123,Washington Wizards,96,27
447,447,Fri Dec 23 2016,Washington Wizards,96,Milwaukee Bucks,123,-27
448,448,Fri Dec 23 2016,Sacramento Kings,109,Minnesota Timberwolves,105,4
1711,448,Fri Dec 23 2016,Minnesota Timberwolves,105,Sacramento Kings,109,-4
1712,449,Fri Dec 23 2016,New Orleans Pelicans,91,Miami Heat,87,4
449,449,Fri Dec 23 2016,Miami Heat,87,New Orleans Pelicans,91,-4
450,450,Fri Dec 23 2016,Los Angeles Lakers,90,Orlando Magic,109,-19
1713,450,Fri Dec 23 2016,Orlando Magic,109,Los Angeles Lakers,90,19
1714,451,Fri Dec 23 2016,Phoenix Suns,123,Philadelphia 76ers,116,7
451,451,Fri Dec 23 2016,Philadelphia 76ers,116,Phoenix Suns,123,-7
1715,452,Fri Dec 23 2016,Portland Trail Blazers,90,San Antonio Spurs,110,-20
452,452,Fri Dec 23 2016,San Antonio Spurs,110,Portland Trail Blazers,90,20
1716,453,Fri Dec 23 2016,Utah Jazz,98,Toronto Raptors,104,-6
453,453,Fri Dec 23 2016,Toronto Raptors,104,Utah Jazz,98,6
454,454,Sun Dec 25 2016,Golden State Warriors,108,Cleveland Cavaliers,109,-1
1717,454,Sun Dec 25 2016,Cleveland Cavaliers,109,Golden State Warriors,108,1
1718,455,Sun Dec 25 2016,Los Angeles Lakers,111,Los Angeles Clippers,102,9
455,455,Sun Dec 25 2016,Los Angeles Clippers,102,Los Angeles Lakers,111,-9
1719,456,Sun Dec 25 2016,New York Knicks,114,Boston Celtics,119,-5
456,456,Sun Dec 25 2016,Boston Celtics,119,New York Knicks,114,5
1720,457,Sun Dec 25 2016,Oklahoma City Thunder,112,Minnesota Timberwolves,100,12
457,457,Sun Dec 25 2016,Minnesota Timberwolves,100,Oklahoma City Thunder,112,-12
458,458,Sun Dec 25 2016,Chicago Bulls,100,San Antonio Spurs,119,-19
1721,458,Sun Dec 25 2016,San Antonio Spurs,119,Chicago Bulls,100,19
459,459,Mon Dec 26 2016,Charlotte Hornets,118,Brooklyn Nets,120,-2
1722,459,Mon Dec 26 2016,Brooklyn Nets,120,Charlotte Hornets,118,2
460,460,Mon Dec 26 2016,Indiana Pacers,85,Chicago Bulls,90,-5
1723,460,Mon Dec 26 2016,Chicago Bulls,90,Indiana Pacers,85,5
461,461,Mon Dec 26 2016,Cleveland Cavaliers,90,Detroit Pistons,106,-16
1724,461,Mon Dec 26 2016,Detroit Pistons,106,Cleveland Cavaliers,90,16
1725,462,Mon Dec 26 2016,Houston Rockets,131,Phoenix Suns,115,16
462,462,Mon Dec 26 2016,Phoenix Suns,115,Houston Rockets,131,-16
463,463,Mon Dec 26 2016,Denver Nuggets,106,Los Angeles Clippers,102,4
1726,463,Mon Dec 26 2016,Los Angeles Clippers,102,Denver Nuggets,106,-4
464,464,Mon Dec 26 2016,Atlanta Hawks,90,Minnesota Timberwolves,104,-14
1727,464,Mon Dec 26 2016,Minnesota Timberwolves,104,Atlanta Hawks,90,14
1728,465,Mon Dec 26 2016,New Orleans Pelicans,111,Dallas Mavericks,104,7
465,465,Mon Dec 26 2016,Dallas Mavericks,104,New Orleans Pelicans,111,-7
466,466,Mon Dec 26 2016,Memphis Grizzlies,102,Orlando Magic,112,-10
1729,466,Mon Dec 26 2016,Orlando Magic,112,Memphis Grizzlies,102,10
467,467,Mon Dec 26 2016,Toronto Raptors,95,Portland Trail Blazers,91,4
1730,467,Mon Dec 26 2016,Portland Trail Blazers,91,Toronto Raptors,95,-4
468,468,Mon Dec 26 2016,Philadelphia 76ers,100,Sacramento Kings,102,-2
1731,468,Mon Dec 26 2016,Sacramento Kings,102,Philadelphia 76ers,100,2
1732,469,Mon Dec 26 2016,Washington Wizards,107,Milwaukee Bucks,102,5
469,469,Mon Dec 26 2016,Milwaukee Bucks,102,Washington Wizards,107,-5
1733,470,Tue Dec 27 2016,Boston Celtics,113,Memphis Grizzlies,103,10
470,470,Tue Dec 27 2016,Memphis Grizzlies,103,Boston Celtics,113,-10
471,471,Tue Dec 27 2016,Houston Rockets,123,Dallas Mavericks,107,16
1734,471,Tue Dec 27 2016,Dallas Mavericks,107,Houston Rockets,123,-16
472,472,Tue Dec 27 2016,Utah Jazz,102,Los Angeles Lakers,100,2
1735,472,Tue Dec 27 2016,Los Angeles Lakers,100,Utah Jazz,102,-2
1736,473,Tue Dec 27 2016,Miami Heat,94,Oklahoma City Thunder,106,-12
473,473,Tue Dec 27 2016,Oklahoma City Thunder,106,Miami Heat,94,12
474,474,Wed Dec 28 2016,New York Knicks,98,Atlanta Hawks,102,-4
1737,474,Wed Dec 28 2016,Atlanta Hawks,102,New York Knicks,98,4
475,475,Wed Dec 28 2016,Brooklyn Nets,99,Chicago Bulls,101,-2
1738,475,Wed Dec 28 2016,Chicago Bulls,101,Brooklyn Nets,99,2
476,476,Wed Dec 28 2016,Minnesota Timberwolves,103,Denver Nuggets,105,-2
1739,476,Wed Dec 28 2016,Denver Nuggets,105,Minnesota Timberwolves,103,2
1740,477,Wed Dec 28 2016,Detroit Pistons,94,Milwaukee Bucks,119,-25
477,477,Wed Dec 28 2016,Milwaukee Bucks,119,Detroit Pistons,94,25
1741,478,Wed Dec 28 2016,Golden State Warriors,121,Toronto Raptors,111,10
478,478,Wed Dec 28 2016,Toronto Raptors,111,Golden State Warriors,121,-10
479,479,Wed Dec 28 2016,Los Angeles Clippers,98,New Orleans Pelicans,102,-4
1742,479,Wed Dec 28 2016,New Orleans Pelicans,102,Los Angeles Clippers,98,4
1743,480,Wed Dec 28 2016,Orlando Magic,101,Charlotte Hornets,120,-19
480,480,Wed Dec 28 2016,Charlotte Hornets,120,Orlando Magic,101,19
1744,481,Wed Dec 28 2016,Portland Trail Blazers,102,Sacramento Kings,89,13
481,481,Wed Dec 28 2016,Sacramento Kings,89,Portland Trail Blazers,102,-13
1745,482,Wed Dec 28 2016,San Antonio Spurs,119,Phoenix Suns,98,21
482,482,Wed Dec 28 2016,Phoenix Suns,98,San Antonio Spurs,119,-21
1746,483,Wed Dec 28 2016,Washington Wizards,111,Indiana Pacers,105,6
483,483,Wed Dec 28 2016,Indiana Pacers,105,Washington Wizards,111,-6
484,484,Thu Dec 29 2016,Miami Heat,82,Charlotte Hornets,91,-9
1747,484,Thu Dec 29 2016,Charlotte Hornets,91,Miami Heat,82,9
1748,485,Thu Dec 29 2016,Cleveland Cavaliers,124,Boston Celtics,118,6
485,485,Thu Dec 29 2016,Boston Celtics,118,Cleveland Cavaliers,124,-6
486,486,Thu Dec 29 2016,Dallas Mavericks,101,Los Angeles Lakers,89,12
1749,486,Thu Dec 29 2016,Los Angeles Lakers,89,Dallas Mavericks,101,-12
1750,487,Thu Dec 29 2016,Memphis Grizzlies,114,Oklahoma City Thunder,80,34
487,487,Thu Dec 29 2016,Oklahoma City Thunder,80,Memphis Grizzlies,114,-34
488,488,Thu Dec 29 2016,Toronto Raptors,91,Phoenix Suns,99,-8
1751,488,Thu Dec 29 2016,Phoenix Suns,99,Toronto Raptors,91,8
489,489,Thu Dec 29 2016,Philadelphia 76ers,83,Utah Jazz,100,-17
1752,489,Thu Dec 29 2016,Utah Jazz,100,Philadelphia 76ers,83,17
490,490,Fri Dec 30 2016,Detroit Pistons,98,Atlanta Hawks,105,-7
1753,490,Fri Dec 30 2016,Atlanta Hawks,105,Detroit Pistons,98,7
491,491,Fri Dec 30 2016,Miami Heat,114,Boston Celtics,117,-3
1754,491,Fri Dec 30 2016,Boston Celtics,117,Miami Heat,114,3
492,492,Fri Dec 30 2016,Philadelphia 76ers,124,Denver Nuggets,122,2
1755,492,Fri Dec 30 2016,Denver Nuggets,122,Philadelphia 76ers,124,-2
493,493,Fri Dec 30 2016,Dallas Mavericks,99,Golden State Warriors,108,-9
1756,493,Fri Dec 30 2016,Golden State Warriors,108,Dallas Mavericks,99,9
494,494,Fri Dec 30 2016,Los Angeles Clippers,116,Houston Rockets,140,-24
1757,494,Fri Dec 30 2016,Houston Rockets,140,Los Angeles Clippers,116,24
495,495,Fri Dec 30 2016,Chicago Bulls,101,Indiana Pacers,111,-10
1758,495,Fri Dec 30 2016,Indiana Pacers,111,Chicago Bulls,101,10
1759,496,Fri Dec 30 2016,Minnesota Timberwolves,116,Milwaukee Bucks,99,17
496,496,Fri Dec 30 2016,Milwaukee Bucks,99,Minnesota Timberwolves,116,-17
1760,497,Fri Dec 30 2016,New Orleans Pelicans,104,New York Knicks,92,12
497,497,Fri Dec 30 2016,New York Knicks,92,New Orleans Pelicans,104,-12
1761,498,Fri Dec 30 2016,San Antonio Spurs,110,Portland Trail Blazers,94,16
498,498,Fri Dec 30 2016,Portland Trail Blazers,94,San Antonio Spurs,110,-16
499,499,Fri Dec 30 2016,Brooklyn Nets,95,Washington Wizards,118,-23
1762,499,Fri Dec 30 2016,Washington Wizards,118,Brooklyn Nets,95,23
1763,500,Sat Dec 31 2016,Chicago Bulls,96,Milwaukee Bucks,116,-20
500,500,Sat Dec 31 2016,Milwaukee Bucks,116,Chicago Bulls,96,20
1764,501,Sat Dec 31 2016,Charlotte Hornets,109,Cleveland Cavaliers,121,-12
501,501,Sat Dec 31 2016,Cleveland Cavaliers,121,Charlotte Hornets,109,12
502,502,Sat Dec 31 2016,New York Knicks,122,Houston Rockets,129,-7
1765,502,Sat Dec 31 2016,Houston Rockets,129,New York Knicks,122,7
503,503,Sat Dec 31 2016,Los Angeles Clippers,88,Oklahoma City Thunder,114,-26
1766,503,Sat Dec 31 2016,Oklahoma City Thunder,114,Los Angeles Clippers,88,26
1767,504,Sat Dec 31 2016,Sacramento Kings,98,Memphis Grizzlies,112,-14
504,504,Sat Dec 31 2016,Memphis Grizzlies,112,Sacramento Kings,98,14
1768,505,Sat Dec 31 2016,Utah Jazz,91,Phoenix Suns,86,5
505,505,Sat Dec 31 2016,Phoenix Suns,86,Utah Jazz,91,-5
1769,506,Sun Jan 1 2017,Atlanta Hawks,114,San Antonio Spurs,112,2
506,506,Sun Jan 1 2017,San Antonio Spurs,112,Atlanta Hawks,114,-2
1770,507,Sun Jan 1 2017,Indiana Pacers,117,Orlando Magic,104,13
507,507,Sun Jan 1 2017,Orlando Magic,104,Indiana Pacers,117,-13
1771,508,Sun Jan 1 2017,Los Angeles Lakers,114,Toronto Raptors,123,-9
508,508,Sun Jan 1 2017,Toronto Raptors,123,Los Angeles Lakers,114,9
1772,509,Sun Jan 1 2017,Miami Heat,98,Detroit Pistons,107,-9
509,509,Sun Jan 1 2017,Detroit Pistons,107,Miami Heat,98,9
1773,510,Sun Jan 1 2017,Minnesota Timberwolves,89,Portland Trail Blazers,95,-6
510,510,Sun Jan 1 2017,Portland Trail Blazers,95,Minnesota Timberwolves,89,6
511,511,Mon Jan 2 2017,Utah Jazz,101,Brooklyn Nets,89,12
1774,511,Mon Jan 2 2017,Brooklyn Nets,89,Utah Jazz,101,-12
1775,512,Mon Jan 2 2017,Chicago Bulls,118,Charlotte Hornets,111,7
512,512,Mon Jan 2 2017,Charlotte Hornets,111,Chicago Bulls,118,-7
513,513,Mon Jan 2 2017,New Orleans Pelicans,82,Cleveland Cavaliers,90,-8
1776,513,Mon Jan 2 2017,Cleveland Cavaliers,90,New Orleans Pelicans,82,8
1777,514,Mon Jan 2 2017,Golden State Warriors,127,Denver Nuggets,119,8
514,514,Mon Jan 2 2017,Denver Nuggets,119,Golden State Warriors,127,-8
1778,515,Mon Jan 2 2017,Houston Rockets,101,Washington Wizards,91,10
515,515,Mon Jan 2 2017,Washington Wizards,91,Houston Rockets,101,-10
516,516,Mon Jan 2 2017,Phoenix Suns,98,Los Angeles Clippers,109,-11
1779,516,Mon Jan 2 2017,Los Angeles Clippers,109,Phoenix Suns,98,11
517,517,Mon Jan 2 2017,Oklahoma City Thunder,94,Milwaukee Bucks,98,-4
1780,517,Mon Jan 2 2017,Milwaukee Bucks,98,Oklahoma City Thunder,94,4
518,518,Mon Jan 2 2017,Orlando Magic,115,New York Knicks,103,12
1781,518,Mon Jan 2 2017,New York Knicks,103,Orlando Magic,115,-12
519,519,Tue Jan 3 2017,Utah Jazz,104,Boston Celtics,115,-11
1782,519,Tue Jan 3 2017,Boston Celtics,115,Utah Jazz,104,11
520,520,Tue Jan 3 2017,Washington Wizards,105,Dallas Mavericks,113,-8
1783,520,Tue Jan 3 2017,Dallas Mavericks,113,Washington Wizards,105,8
521,521,Tue Jan 3 2017,Sacramento Kings,120,Denver Nuggets,113,7
1784,521,Tue Jan 3 2017,Denver Nuggets,113,Sacramento Kings,120,-7
522,522,Tue Jan 3 2017,Indiana Pacers,121,Detroit Pistons,116,5
1785,522,Tue Jan 3 2017,Detroit Pistons,116,Indiana Pacers,121,-5
523,523,Tue Jan 3 2017,Memphis Grizzlies,102,Los Angeles Lakers,116,-14
1786,523,Tue Jan 3 2017,Los Angeles Lakers,116,Memphis Grizzlies,102,14
524,524,Tue Jan 3 2017,Minnesota Timberwolves,91,Philadelphia 76ers,93,-2
1787,524,Tue Jan 3 2017,Philadelphia 76ers,93,Minnesota Timberwolves,91,2
1788,525,Tue Jan 3 2017,Phoenix Suns,99,Miami Heat,90,9
525,525,Tue Jan 3 2017,Miami Heat,90,Phoenix Suns,99,-9
1789,526,Tue Jan 3 2017,San Antonio Spurs,110,Toronto Raptors,82,28
526,526,Tue Jan 3 2017,Toronto Raptors,82,San Antonio Spurs,110,-28
527,527,Wed Jan 4 2017,Oklahoma City Thunder,112,Charlotte Hornets,123,-11
1790,527,Wed Jan 4 2017,Charlotte Hornets,123,Oklahoma City Thunder,112,11
528,528,Wed Jan 4 2017,Chicago Bulls,106,Cleveland Cavaliers,94,12
1791,528,Wed Jan 4 2017,Cleveland Cavaliers,94,Chicago Bulls,106,-12
1792,529,Wed Jan 4 2017,Golden State Warriors,125,Portland Trail Blazers,117,8
529,529,Wed Jan 4 2017,Portland Trail Blazers,117,Golden State Warriors,125,-8
1793,530,Wed Jan 4 2017,Los Angeles Clippers,115,Memphis Grizzlies,106,9
530,530,Wed Jan 4 2017,Memphis Grizzlies,106,Los Angeles Clippers,115,-9
1794,531,Wed Jan 4 2017,New York Knicks,104,Milwaukee Bucks,105,-1
531,531,Wed Jan 4 2017,Milwaukee Bucks,105,New York Knicks,104,1
532,532,Wed Jan 4 2017,Atlanta Hawks,111,Orlando Magic,92,19
1795,532,Wed Jan 4 2017,Orlando Magic,92,Atlanta Hawks,111,-19
1796,533,Wed Jan 4 2017,Sacramento Kings,102,Miami Heat,107,-5
533,533,Wed Jan 4 2017,Miami Heat,107,Sacramento Kings,102,5
534,534,Thu Jan 5 2017,Phoenix Suns,102,Dallas Mavericks,95,7
1797,534,Thu Jan 5 2017,Dallas Mavericks,95,Phoenix Suns,102,-7
535,535,Thu Jan 5 2017,San Antonio Spurs,127,Denver Nuggets,99,28
1798,535,Thu Jan 5 2017,Denver Nuggets,99,San Antonio Spurs,127,-28
1799,536,Thu Jan 5 2017,Detroit Pistons,115,Charlotte Hornets,114,1
536,536,Thu Jan 5 2017,Charlotte Hornets,114,Detroit Pistons,115,-1
1800,537,Thu Jan 5 2017,Houston Rockets,118,Oklahoma City Thunder,116,2
537,537,Thu Jan 5 2017,Oklahoma City Thunder,116,Houston Rockets,118,-2
538,538,Thu Jan 5 2017,Brooklyn Nets,109,Indiana Pacers,121,-12
1801,538,Thu Jan 5 2017,Indiana Pacers,121,Brooklyn Nets,109,12
1802,539,Thu Jan 5 2017,New Orleans Pelicans,94,Atlanta Hawks,99,-5
539,539,Thu Jan 5 2017,Atlanta Hawks,99,New Orleans Pelicans,94,5
1803,540,Thu Jan 5 2017,Portland Trail Blazers,118,Los Angeles Lakers,109,9
540,540,Thu Jan 5 2017,Los Angeles Lakers,109,Portland Trail Blazers,118,-9
1804,541,Thu Jan 5 2017,Toronto Raptors,101,Utah Jazz,93,8
541,541,Thu Jan 5 2017,Utah Jazz,93,Toronto Raptors,101,-8
1805,542,Fri Jan 6 2017,Boston Celtics,110,Philadelphia 76ers,106,4
542,542,Fri Jan 6 2017,Philadelphia 76ers,106,Boston Celtics,110,-4
543,543,Fri Jan 6 2017,Cleveland Cavaliers,116,Brooklyn Nets,108,8
1806,543,Fri Jan 6 2017,Brooklyn Nets,108,Cleveland Cavaliers,116,-8
544,544,Fri Jan 6 2017,Memphis Grizzlies,128,Golden State Warriors,119,9
1807,544,Fri Jan 6 2017,Golden State Warriors,119,Memphis Grizzlies,128,-9
1808,545,Fri Jan 6 2017,Los Angeles Lakers,127,Miami Heat,100,27
545,545,Fri Jan 6 2017,Miami Heat,100,Los Angeles Lakers,127,-27
546,546,Fri Jan 6 2017,New York Knicks,116,Milwaukee Bucks,111,5
1809,546,Fri Jan 6 2017,Milwaukee Bucks,111,New York Knicks,116,-5
547,547,Fri Jan 6 2017,Houston Rockets,100,Orlando Magic,93,7
1810,547,Fri Jan 6 2017,Orlando Magic,93,Houston Rockets,100,-7
548,548,Fri Jan 6 2017,Los Angeles Clippers,106,Sacramento Kings,98,8
1811,548,Fri Jan 6 2017,Sacramento Kings,98,Los Angeles Clippers,106,-8
1812,549,Fri Jan 6 2017,Washington Wizards,112,Minnesota Timberwolves,105,7
549,549,Fri Jan 6 2017,Minnesota Timberwolves,105,Washington Wizards,112,-7
550,550,Sat Jan 7 2017,New Orleans Pelicans,108,Boston Celtics,117,-9
1813,550,Sat Jan 7 2017,Boston Celtics,117,New Orleans Pelicans,108,9
1814,551,Sat Jan 7 2017,Chicago Bulls,123,Toronto Raptors,118,5
551,551,Sat Jan 7 2017,Toronto Raptors,118,Chicago Bulls,123,-5
552,552,Sat Jan 7 2017,Atlanta Hawks,97,Dallas Mavericks,82,15
1815,552,Sat Jan 7 2017,Dallas Mavericks,82,Atlanta Hawks,97,-15
553,553,Sat Jan 7 2017,New York Knicks,109,Indiana Pacers,123,-14
1816,553,Sat Jan 7 2017,Indiana Pacers,123,New York Knicks,109,14
554,554,Sat Jan 7 2017,Utah Jazz,94,Minnesota Timberwolves,92,2
1817,554,Sat Jan 7 2017,Minnesota Timberwolves,92,Utah Jazz,94,-2
555,555,Sat Jan 7 2017,Denver Nuggets,106,Oklahoma City Thunder,121,-15
1818,555,Sat Jan 7 2017,Oklahoma City Thunder,121,Denver Nuggets,106,15
1819,556,Sat Jan 7 2017,San Antonio Spurs,102,Charlotte Hornets,85,17
556,556,Sat Jan 7 2017,Charlotte Hornets,85,San Antonio Spurs,102,-17
557,557,Sun Jan 8 2017,Philadelphia 76ers,105,Brooklyn Nets,95,10
1820,557,Sun Jan 8 2017,Brooklyn Nets,95,Philadelphia 76ers,105,-10
1821,558,Sun Jan 8 2017,Los Angeles Clippers,98,Miami Heat,86,12
558,558,Sun Jan 8 2017,Miami Heat,86,Los Angeles Clippers,98,-12
559,559,Sun Jan 8 2017,Orlando Magic,95,Los Angeles Lakers,111,-16
1822,559,Sun Jan 8 2017,Los Angeles Lakers,111,Orlando Magic,95,16
1823,560,Sun Jan 8 2017,Memphis Grizzlies,88,Utah Jazz,79,9
560,560,Sun Jan 8 2017,Utah Jazz,79,Memphis Grizzlies,88,-9
1824,561,Sun Jan 8 2017,Milwaukee Bucks,101,Washington Wizards,107,-6
561,561,Sun Jan 8 2017,Washington Wizards,107,Milwaukee Bucks,101,6
1825,562,Sun Jan 8 2017,Phoenix Suns,116,Cleveland Cavaliers,120,-4
562,562,Sun Jan 8 2017,Cleveland Cavaliers,120,Phoenix Suns,116,4
1826,563,Sun Jan 8 2017,Portland Trail Blazers,124,Detroit Pistons,125,-1
563,563,Sun Jan 8 2017,Detroit Pistons,125,Portland Trail Blazers,124,1
1827,564,Sun Jan 8 2017,Sacramento Kings,106,Golden State Warriors,117,-11
564,564,Sun Jan 8 2017,Golden State Warriors,117,Sacramento Kings,106,11
565,565,Sun Jan 8 2017,Houston Rockets,129,Toronto Raptors,122,7
1828,565,Sun Jan 8 2017,Toronto Raptors,122,Houston Rockets,129,-7
566,566,Mon Jan 9 2017,Oklahoma City Thunder,109,Chicago Bulls,94,15
1829,566,Mon Jan 9 2017,Chicago Bulls,94,Oklahoma City Thunder,109,-15
1830,567,Mon Jan 9 2017,Minnesota Timberwolves,101,Dallas Mavericks,92,9
567,567,Mon Jan 9 2017,Dallas Mavericks,92,Minnesota Timberwolves,101,-9
1831,568,Mon Jan 9 2017,New York Knicks,96,New Orleans Pelicans,110,-14
568,568,Mon Jan 9 2017,New Orleans Pelicans,110,New York Knicks,96,14
1832,569,Tue Jan 10 2017,Brooklyn Nets,97,Atlanta Hawks,117,-20
569,569,Tue Jan 10 2017,Atlanta Hawks,117,Brooklyn Nets,97,20
1833,570,Tue Jan 10 2017,Golden State Warriors,107,Miami Heat,95,12
570,570,Tue Jan 10 2017,Miami Heat,95,Golden State Warriors,107,-12
571,571,Tue Jan 10 2017,Charlotte Hornets,114,Houston Rockets,121,-7
1834,571,Tue Jan 10 2017,Houston Rockets,121,Charlotte Hornets,114,7
1835,572,Tue Jan 10 2017,Los Angeles Lakers,87,Portland Trail Blazers,108,-21
572,572,Tue Jan 10 2017,Portland Trail Blazers,108,Los Angeles Lakers,87,21
1836,573,Tue Jan 10 2017,Sacramento Kings,100,Detroit Pistons,94,6
573,573,Tue Jan 10 2017,Detroit Pistons,94,Sacramento Kings,100,-6
574,574,Tue Jan 10 2017,Milwaukee Bucks,109,San Antonio Spurs,107,2
1837,574,Tue Jan 10 2017,San Antonio Spurs,107,Milwaukee Bucks,109,-2
575,575,Tue Jan 10 2017,Boston Celtics,106,Toronto Raptors,114,-8
1838,575,Tue Jan 10 2017,Toronto Raptors,114,Boston Celtics,106,8
576,576,Tue Jan 10 2017,Cleveland Cavaliers,92,Utah Jazz,100,-8
1839,576,Tue Jan 10 2017,Utah Jazz,100,Cleveland Cavaliers,92,8
577,577,Tue Jan 10 2017,Chicago Bulls,99,Washington Wizards,101,-2
1840,577,Tue Jan 10 2017,Washington Wizards,101,Chicago Bulls,99,2
1841,578,Wed Jan 11 2017,Boston Celtics,117,Washington Wizards,108,9
578,578,Wed Jan 11 2017,Washington Wizards,108,Boston Celtics,117,-9
1842,579,Wed Jan 11 2017,Los Angeles Clippers,105,Orlando Magic,96,9
579,579,Wed Jan 11 2017,Orlando Magic,96,Los Angeles Clippers,105,-9
1843,580,Wed Jan 11 2017,Minnesota Timberwolves,119,Houston Rockets,105,14
580,580,Wed Jan 11 2017,Houston Rockets,105,Minnesota Timberwolves,119,-14
581,581,Wed Jan 11 2017,Memphis Grizzlies,95,Oklahoma City Thunder,103,-8
1844,581,Wed Jan 11 2017,Oklahoma City Thunder,103,Memphis Grizzlies,95,8
1845,582,Wed Jan 11 2017,Philadelphia 76ers,98,New York Knicks,97,1
582,582,Wed Jan 11 2017,New York Knicks,97,Philadelphia 76ers,98,-1
1846,583,Wed Jan 11 2017,Portland Trail Blazers,102,Cleveland Cavaliers,86,16
583,583,Wed Jan 11 2017,Cleveland Cavaliers,86,Portland Trail Blazers,102,-16
1847,584,Thu Jan 12 2017,Brooklyn Nets,95,New Orleans Pelicans,104,-9
584,584,Thu Jan 12 2017,New Orleans Pelicans,104,Brooklyn Nets,95,9
1848,585,Thu Jan 12 2017,Denver Nuggets,140,Indiana Pacers,112,28
585,585,Thu Jan 12 2017,Indiana Pacers,112,Denver Nuggets,140,-28
1849,586,Thu Jan 12 2017,Golden State Warriors,127,Detroit Pistons,107,20
586,586,Thu Jan 12 2017,Detroit Pistons,107,Golden State Warriors,127,-20
587,587,Thu Jan 12 2017,Chicago Bulls,89,New York Knicks,104,-15
1850,587,Thu Jan 12 2017,New York Knicks,104,Chicago Bulls,89,15
588,588,Thu Jan 12 2017,Dallas Mavericks,113,Phoenix Suns,108,5
1851,588,Thu Jan 12 2017,Phoenix Suns,108,Dallas Mavericks,113,-5
589,589,Thu Jan 12 2017,Los Angeles Lakers,94,San Antonio Spurs,134,-40
1852,589,Thu Jan 12 2017,San Antonio Spurs,134,Los Angeles Lakers,94,40
590,590,Fri Jan 13 2017,Boston Celtics,103,Atlanta Hawks,101,2
1853,590,Fri Jan 13 2017,Atlanta Hawks,101,Boston Celtics,103,-2
591,591,Fri Jan 13 2017,Memphis Grizzlies,110,Houston Rockets,105,5
1854,591,Fri Jan 13 2017,Houston Rockets,105,Memphis Grizzlies,110,-5
592,592,Fri Jan 13 2017,Miami Heat,108,Milwaukee Bucks,116,-8
1855,592,Fri Jan 13 2017,Milwaukee Bucks,116,Miami Heat,108,8
593,593,Fri Jan 13 2017,Oklahoma City Thunder,86,Minnesota Timberwolves,96,-10
1856,593,Fri Jan 13 2017,Minnesota Timberwolves,96,Oklahoma City Thunder,86,10
594,594,Fri Jan 13 2017,Charlotte Hornets,93,Philadelphia 76ers,102,-9
1857,594,Fri Jan 13 2017,Philadelphia 76ers,102,Charlotte Hornets,93,9
595,595,Fri Jan 13 2017,Orlando Magic,115,Portland Trail Blazers,109,6
1858,595,Fri Jan 13 2017,Portland Trail Blazers,109,Orlando Magic,115,-6
1859,596,Fri Jan 13 2017,Sacramento Kings,108,Cleveland Cavaliers,120,-12
596,596,Fri Jan 13 2017,Cleveland Cavaliers,120,Sacramento Kings,108,12
1860,597,Fri Jan 13 2017,Toronto Raptors,132,Brooklyn Nets,113,19
597,597,Fri Jan 13 2017,Brooklyn Nets,113,Toronto Raptors,132,-19
1861,598,Fri Jan 13 2017,Utah Jazz,110,Detroit Pistons,77,33
598,598,Fri Jan 13 2017,Detroit Pistons,77,Utah Jazz,110,-33
1862,599,Sat Jan 14 2017,Chicago Bulls,107,New Orleans Pelicans,99,8
599,599,Sat Jan 14 2017,New Orleans Pelicans,99,Chicago Bulls,107,-8
1863,600,Sat Jan 14 2017,Los Angeles Clippers,113,Los Angeles Lakers,97,16
600,600,Sat Jan 14 2017,Los Angeles Lakers,97,Los Angeles Clippers,113,-16
1864,601,Sat Jan 14 2017,Phoenix Suns,108,San Antonio Spurs,105,3
601,601,Sat Jan 14 2017,San Antonio Spurs,105,Phoenix Suns,108,-3
602,602,Sat Jan 14 2017,Orlando Magic,107,Utah Jazz,114,-7
1865,602,Sat Jan 14 2017,Utah Jazz,114,Orlando Magic,107,7
1866,603,Sat Jan 14 2017,Washington Wizards,109,Philadelphia 76ers,93,16
603,603,Sat Jan 14 2017,Philadelphia 76ers,93,Washington Wizards,109,-16
1867,604,Sun Jan 15 2017,Atlanta Hawks,111,Milwaukee Bucks,98,13
604,604,Sun Jan 15 2017,Milwaukee Bucks,98,Atlanta Hawks,111,-13
605,605,Sun Jan 15 2017,Houston Rockets,137,Brooklyn Nets,112,25
1868,605,Sun Jan 15 2017,Brooklyn Nets,112,Houston Rockets,137,-25
606,606,Sun Jan 15 2017,Minnesota Timberwolves,87,Dallas Mavericks,98,-11
1869,606,Sun Jan 15 2017,Dallas Mavericks,98,Minnesota Timberwolves,87,11
607,607,Sun Jan 15 2017,Detroit Pistons,102,Los Angeles Lakers,97,5
1870,607,Sun Jan 15 2017,Los Angeles Lakers,97,Detroit Pistons,102,-5
608,608,Sun Jan 15 2017,Chicago Bulls,108,Memphis Grizzlies,104,4
1871,608,Sun Jan 15 2017,Memphis Grizzlies,104,Chicago Bulls,108,-4
609,609,Sun Jan 15 2017,Oklahoma City Thunder,122,Sacramento Kings,118,4
1872,609,Sun Jan 15 2017,Sacramento Kings,118,Oklahoma City Thunder,122,-4
1873,610,Sun Jan 15 2017,Toronto Raptors,116,New York Knicks,101,15
610,610,Sun Jan 15 2017,New York Knicks,101,Toronto Raptors,116,-15
1874,611,Mon Jan 16 2017,Boston Celtics,108,Charlotte Hornets,98,10
611,611,Mon Jan 16 2017,Charlotte Hornets,98,Boston Celtics,108,-10
1875,612,Mon Jan 16 2017,Denver Nuggets,125,Orlando Magic,112,13
612,612,Mon Jan 16 2017,Orlando Magic,112,Denver Nuggets,125,-13
1876,613,Mon Jan 16 2017,Golden State Warriors,126,Cleveland Cavaliers,91,35
613,613,Mon Jan 16 2017,Cleveland Cavaliers,91,Golden State Warriors,126,-35
614,614,Mon Jan 16 2017,New Orleans Pelicans,95,Indiana Pacers,98,-3
1877,614,Mon Jan 16 2017,Indiana Pacers,98,New Orleans Pelicans,95,3
615,615,Mon Jan 16 2017,Oklahoma City Thunder,98,Los Angeles Clippers,120,-22
1878,615,Mon Jan 16 2017,Los Angeles Clippers,120,Oklahoma City Thunder,98,22
616,616,Mon Jan 16 2017,Philadelphia 76ers,113,Milwaukee Bucks,104,9
1879,616,Mon Jan 16 2017,Milwaukee Bucks,104,Philadelphia 76ers,113,-9
617,617,Mon Jan 16 2017,Atlanta Hawks,108,New York Knicks,107,1
1880,617,Mon Jan 16 2017,New York Knicks,107,Atlanta Hawks,108,-1
618,618,Mon Jan 16 2017,Utah Jazz,106,Phoenix Suns,101,5
1881,618,Mon Jan 16 2017,Phoenix Suns,101,Utah Jazz,106,-5
619,619,Mon Jan 16 2017,Portland Trail Blazers,101,Washington Wizards,120,-19
1882,619,Mon Jan 16 2017,Washington Wizards,120,Portland Trail Blazers,101,19
620,620,Tue Jan 17 2017,Toronto Raptors,119,Brooklyn Nets,109,10
1883,620,Tue Jan 17 2017,Brooklyn Nets,109,Toronto Raptors,119,-10
1884,621,Tue Jan 17 2017,Chicago Bulls,98,Dallas Mavericks,99,-1
621,621,Tue Jan 17 2017,Dallas Mavericks,99,Chicago Bulls,98,1
1885,622,Tue Jan 17 2017,Los Angeles Lakers,121,Denver Nuggets,127,-6
622,622,Tue Jan 17 2017,Denver Nuggets,127,Los Angeles Lakers,121,6
1886,623,Tue Jan 17 2017,Miami Heat,109,Houston Rockets,103,6
623,623,Tue Jan 17 2017,Houston Rockets,103,Miami Heat,109,-6
624,624,Tue Jan 17 2017,Minnesota Timberwolves,114,San Antonio Spurs,122,-8
1887,624,Tue Jan 17 2017,San Antonio Spurs,122,Minnesota Timberwolves,114,8
1888,625,Wed Jan 18 2017,Boston Celtics,106,New York Knicks,117,-11
625,625,Wed Jan 18 2017,New York Knicks,117,Boston Celtics,106,11
626,626,Wed Jan 18 2017,Portland Trail Blazers,85,Charlotte Hornets,107,-22
1889,626,Wed Jan 18 2017,Charlotte Hornets,107,Portland Trail Blazers,85,22
627,627,Wed Jan 18 2017,Atlanta Hawks,95,Detroit Pistons,118,-23
1890,627,Wed Jan 18 2017,Detroit Pistons,118,Atlanta Hawks,95,23
628,628,Wed Jan 18 2017,Oklahoma City Thunder,100,Golden State Warriors,121,-21
1891,628,Wed Jan 18 2017,Golden State Warriors,121,Oklahoma City Thunder,100,21
1892,629,Wed Jan 18 2017,Houston Rockets,111,Milwaukee Bucks,92,19
629,629,Wed Jan 18 2017,Milwaukee Bucks,92,Houston Rockets,111,-19
1893,630,Wed Jan 18 2017,New Orleans Pelicans,118,Orlando Magic,98,20
630,630,Wed Jan 18 2017,Orlando Magic,98,New Orleans Pelicans,118,-20
1894,631,Wed Jan 18 2017,Philadelphia 76ers,94,Toronto Raptors,89,5
631,631,Wed Jan 18 2017,Toronto Raptors,89,Philadelphia 76ers,94,-5
632,632,Wed Jan 18 2017,Indiana Pacers,106,Sacramento Kings,100,6
1895,632,Wed Jan 18 2017,Sacramento Kings,100,Indiana Pacers,106,-6
1896,633,Wed Jan 18 2017,Washington Wizards,104,Memphis Grizzlies,101,3
633,633,Wed Jan 18 2017,Memphis Grizzlies,101,Washington Wizards,104,-3
1897,634,Thu Jan 19 2017,Cleveland Cavaliers,118,Phoenix Suns,103,15
634,634,Thu Jan 19 2017,Phoenix Suns,103,Cleveland Cavaliers,118,-15
1898,635,Thu Jan 19 2017,Los Angeles Clippers,101,Minnesota Timberwolves,104,-3
635,635,Thu Jan 19 2017,Minnesota Timberwolves,104,Los Angeles Clippers,101,3
1899,636,Thu Jan 19 2017,Miami Heat,99,Dallas Mavericks,95,4
636,636,Thu Jan 19 2017,Dallas Mavericks,95,Miami Heat,99,-4
1900,637,Thu Jan 19 2017,New York Knicks,110,Washington Wizards,113,-3
637,637,Thu Jan 19 2017,Washington Wizards,113,New York Knicks,110,3
638,638,Thu Jan 19 2017,Denver Nuggets,104,San Antonio Spurs,118,-14
1901,638,Thu Jan 19 2017,San Antonio Spurs,118,Denver Nuggets,104,14
1902,639,Fri Jan 20 2017,Atlanta Hawks,102,Chicago Bulls,93,9
639,639,Fri Jan 20 2017,Chicago Bulls,93,Atlanta Hawks,102,-9
640,640,Fri Jan 20 2017,Toronto Raptors,78,Charlotte Hornets,113,-35
1903,640,Fri Jan 20 2017,Charlotte Hornets,113,Toronto Raptors,78,35
1904,641,Fri Jan 20 2017,Dallas Mavericks,107,Utah Jazz,112,-5
641,641,Fri Jan 20 2017,Utah Jazz,112,Dallas Mavericks,107,5
642,642,Fri Jan 20 2017,Golden State Warriors,125,Houston Rockets,108,17
1905,642,Fri Jan 20 2017,Houston Rockets,108,Golden State Warriors,125,-17
1906,643,Fri Jan 20 2017,Los Angeles Lakers,108,Indiana Pacers,95,13
643,643,Fri Jan 20 2017,Indiana Pacers,95,Los Angeles Lakers,108,-13
644,644,Fri Jan 20 2017,Sacramento Kings,91,Memphis Grizzlies,107,-16
1907,644,Fri Jan 20 2017,Memphis Grizzlies,107,Sacramento Kings,91,16
645,645,Fri Jan 20 2017,Brooklyn Nets,143,New Orleans Pelicans,114,29
1908,645,Fri Jan 20 2017,New Orleans Pelicans,114,Brooklyn Nets,143,-29
1909,646,Fri Jan 20 2017,Orlando Magic,112,Milwaukee Bucks,96,16
646,646,Fri Jan 20 2017,Milwaukee Bucks,96,Orlando Magic,112,-16
1910,647,Fri Jan 20 2017,Philadelphia 76ers,93,Portland Trail Blazers,92,1
647,647,Fri Jan 20 2017,Portland Trail Blazers,92,Philadelphia 76ers,93,-1
1911,648,Sat Jan 21 2017,Atlanta Hawks,110,Philadelphia 76ers,93,17
648,648,Sat Jan 21 2017,Philadelphia 76ers,93,Atlanta Hawks,110,-17
649,649,Sat Jan 21 2017,Portland Trail Blazers,127,Boston Celtics,123,4
1912,649,Sat Jan 21 2017,Boston Celtics,123,Portland Trail Blazers,127,-4
1913,650,Sat Jan 21 2017,Chicago Bulls,102,Sacramento Kings,99,3
650,650,Sat Jan 21 2017,Sacramento Kings,99,Chicago Bulls,102,-3
1914,651,Sat Jan 21 2017,Charlotte Hornets,112,Brooklyn Nets,105,7
651,651,Sat Jan 21 2017,Brooklyn Nets,105,Charlotte Hornets,112,-7
1915,652,Sat Jan 21 2017,Cleveland Cavaliers,115,San Antonio Spurs,118,-3
652,652,Sat Jan 21 2017,San Antonio Spurs,118,Cleveland Cavaliers,115,3
653,653,Sat Jan 21 2017,Los Angeles Clippers,98,Denver Nuggets,123,-25
1916,653,Sat Jan 21 2017,Denver Nuggets,123,Los Angeles Clippers,98,25
1917,654,Sat Jan 21 2017,Detroit Pistons,113,Washington Wizards,112,1
654,654,Sat Jan 21 2017,Washington Wizards,112,Detroit Pistons,113,-1
1918,655,Sat Jan 21 2017,Memphis Grizzlies,95,Houston Rockets,119,-24
655,655,Sat Jan 21 2017,Houston Rockets,119,Memphis Grizzlies,95,24
1919,656,Sat Jan 21 2017,Miami Heat,109,Milwaukee Bucks,97,12
656,656,Sat Jan 21 2017,Milwaukee Bucks,97,Miami Heat,109,-12
1920,657,Sat Jan 21 2017,New York Knicks,105,Phoenix Suns,107,-2
657,657,Sat Jan 21 2017,Phoenix Suns,107,New York Knicks,105,2
1921,658,Sat Jan 21 2017,Utah Jazz,109,Indiana Pacers,100,9
658,658,Sat Jan 21 2017,Indiana Pacers,100,Utah Jazz,109,-9
1922,659,Sun Jan 22 2017,Dallas Mavericks,122,Los Angeles Lakers,73,49
659,659,Sun Jan 22 2017,Los Angeles Lakers,73,Dallas Mavericks,122,-49
1923,660,Sun Jan 22 2017,Minnesota Timberwolves,111,Denver Nuggets,108,3
660,660,Sun Jan 22 2017,Denver Nuggets,108,Minnesota Timberwolves,111,-3
661,661,Sun Jan 22 2017,Golden State Warriors,118,Orlando Magic,98,20
1924,661,Sun Jan 22 2017,Orlando Magic,98,Golden State Warriors,118,-20
662,662,Sun Jan 22 2017,Phoenix Suns,115,Toronto Raptors,103,12
1925,662,Sun Jan 22 2017,Toronto Raptors,103,Phoenix Suns,115,-12
663,663,Mon Jan 23 2017,Los Angeles Clippers,115,Atlanta Hawks,105,10
1926,663,Mon Jan 23 2017,Atlanta Hawks,105,Los Angeles Clippers,115,-10
664,664,Mon Jan 23 2017,San Antonio Spurs,112,Brooklyn Nets,86,26
1927,664,Mon Jan 23 2017,Brooklyn Nets,86,San Antonio Spurs,112,-26
665,665,Mon Jan 23 2017,Washington Wizards,109,Charlotte Hornets,99,10
1928,665,Mon Jan 23 2017,Charlotte Hornets,99,Washington Wizards,109,-10
666,666,Mon Jan 23 2017,Sacramento Kings,109,Detroit Pistons,104,5
1929,666,Mon Jan 23 2017,Detroit Pistons,104,Sacramento Kings,109,-5
1930,667,Mon Jan 23 2017,Indiana Pacers,103,New York Knicks,109,-6
667,667,Mon Jan 23 2017,New York Knicks,109,Indiana Pacers,103,6
668,668,Mon Jan 23 2017,Golden State Warriors,102,Miami Heat,105,-3
1931,668,Mon Jan 23 2017,Miami Heat,105,Golden State Warriors,102,3
1932,669,Mon Jan 23 2017,Milwaukee Bucks,127,Houston Rockets,114,13
669,669,Mon Jan 23 2017,Houston Rockets,114,Milwaukee Bucks,127,-13
670,670,Mon Jan 23 2017,Cleveland Cavaliers,122,New Orleans Pelicans,124,-2
1933,670,Mon Jan 23 2017,New Orleans Pelicans,124,Cleveland Cavaliers,122,2
671,671,Mon Jan 23 2017,Oklahoma City Thunder,97,Utah Jazz,95,2
1934,671,Mon Jan 23 2017,Utah Jazz,95,Oklahoma City Thunder,97,-2
672,672,Tue Jan 24 2017,Utah Jazz,93,Denver Nuggets,103,-10
1935,672,Tue Jan 24 2017,Denver Nuggets,103,Utah Jazz,93,10
1936,673,Tue Jan 24 2017,Orlando Magic,92,Chicago Bulls,100,-8
673,673,Tue Jan 24 2017,Chicago Bulls,100,Orlando Magic,92,8
1937,674,Tue Jan 24 2017,Philadelphia 76ers,121,Los Angeles Clippers,110,11
674,674,Tue Jan 24 2017,Los Angeles Clippers,110,Philadelphia 76ers,121,-11
1938,675,Tue Jan 24 2017,Phoenix Suns,111,Minnesota Timberwolves,112,-1
675,675,Tue Jan 24 2017,Minnesota Timberwolves,112,Phoenix Suns,111,1
676,676,Tue Jan 24 2017,San Antonio Spurs,108,Toronto Raptors,106,2
1939,676,Tue Jan 24 2017,Toronto Raptors,106,San Antonio Spurs,108,-2
677,677,Tue Jan 24 2017,Boston Celtics,108,Washington Wizards,123,-15
1940,677,Tue Jan 24 2017,Washington Wizards,123,Boston Celtics,108,15
1941,678,Wed Jan 25 2017,Boston Celtics,120,Houston Rockets,109,11
678,678,Wed Jan 25 2017,Houston Rockets,109,Boston Celtics,120,-11
1942,679,Wed Jan 25 2017,Brooklyn Nets,106,Miami Heat,109,-3
679,679,Wed Jan 25 2017,Miami Heat,109,Brooklyn Nets,106,3
1943,680,Wed Jan 25 2017,Chicago Bulls,114,Atlanta Hawks,119,-5
680,680,Wed Jan 25 2017,Atlanta Hawks,119,Chicago Bulls,114,5
1944,681,Wed Jan 25 2017,Charlotte Hornets,103,Golden State Warriors,113,-10
681,681,Wed Jan 25 2017,Golden State Warriors,113,Charlotte Hornets,103,10
682,682,Wed Jan 25 2017,Sacramento Kings,116,Cleveland Cavaliers,112,4
1945,682,Wed Jan 25 2017,Cleveland Cavaliers,112,Sacramento Kings,116,-4
683,683,Wed Jan 25 2017,New York Knicks,95,Dallas Mavericks,103,-8
1946,683,Wed Jan 25 2017,Dallas Mavericks,103,New York Knicks,95,8
684,684,Wed Jan 25 2017,Toronto Raptors,99,Memphis Grizzlies,101,-2
1947,684,Wed Jan 25 2017,Memphis Grizzlies,101,Toronto Raptors,99,2
1948,685,Wed Jan 25 2017,Milwaukee Bucks,109,Philadelphia 76ers,114,-5
685,685,Wed Jan 25 2017,Philadelphia 76ers,114,Milwaukee Bucks,109,5
1949,686,Wed Jan 25 2017,New Orleans Pelicans,105,Oklahoma City Thunder,114,-9
686,686,Wed Jan 25 2017,Oklahoma City Thunder,114,New Orleans Pelicans,105,9
1950,687,Wed Jan 25 2017,Portland Trail Blazers,105,Los Angeles Lakers,98,7
687,687,Wed Jan 25 2017,Los Angeles Lakers,98,Portland Trail Blazers,105,-7
688,688,Thu Jan 26 2017,Phoenix Suns,120,Denver Nuggets,127,-7
1951,688,Thu Jan 26 2017,Denver Nuggets,127,Phoenix Suns,120,7
689,689,Thu Jan 26 2017,Indiana Pacers,109,Minnesota Timberwolves,103,6
1952,689,Thu Jan 26 2017,Minnesota Timberwolves,103,Indiana Pacers,109,-6
690,690,Thu Jan 26 2017,Dallas Mavericks,98,Oklahoma City Thunder,109,-11
1953,690,Thu Jan 26 2017,Oklahoma City Thunder,109,Dallas Mavericks,98,11
691,691,Thu Jan 26 2017,Los Angeles Lakers,88,Utah Jazz,96,-8
1954,691,Thu Jan 26 2017,Utah Jazz,96,Los Angeles Lakers,88,8
692,692,Fri Jan 27 2017,Washington Wizards,112,Atlanta Hawks,86,26
1955,692,Fri Jan 27 2017,Atlanta Hawks,86,Washington Wizards,112,-26
693,693,Fri Jan 27 2017,Orlando Magic,98,Boston Celtics,128,-30
1956,693,Fri Jan 27 2017,Boston Celtics,128,Orlando Magic,98,30
694,694,Fri Jan 27 2017,Miami Heat,100,Chicago Bulls,88,12
1957,694,Fri Jan 27 2017,Chicago Bulls,88,Miami Heat,100,-12
695,695,Fri Jan 27 2017,Brooklyn Nets,116,Cleveland Cavaliers,124,-8
1958,695,Fri Jan 27 2017,Cleveland Cavaliers,124,Brooklyn Nets,116,8
696,696,Fri Jan 27 2017,Sacramento Kings,111,Indiana Pacers,115,-4
1959,696,Fri Jan 27 2017,Indiana Pacers,115,Sacramento Kings,111,4
697,697,Fri Jan 27 2017,San Antonio Spurs,103,New Orleans Pelicans,119,-16
1960,697,Fri Jan 27 2017,New Orleans Pelicans,119,San Antonio Spurs,103,16
698,698,Fri Jan 27 2017,Charlotte Hornets,107,New York Knicks,110,-3
1961,698,Fri Jan 27 2017,New York Knicks,110,Charlotte Hornets,107,3
699,699,Fri Jan 27 2017,Houston Rockets,123,Philadelphia 76ers,118,5
1962,699,Fri Jan 27 2017,Philadelphia 76ers,118,Houston Rockets,123,-5
700,700,Fri Jan 27 2017,Memphis Grizzlies,109,Portland Trail Blazers,112,-3
1963,700,Fri Jan 27 2017,Portland Trail Blazers,112,Memphis Grizzlies,109,3
1964,701,Fri Jan 27 2017,Toronto Raptors,102,Milwaukee Bucks,86,16
701,701,Fri Jan 27 2017,Milwaukee Bucks,86,Toronto Raptors,102,-16
1965,702,Sat Jan 28 2017,Charlotte Hornets,106,Sacramento Kings,109,-3
702,702,Sat Jan 28 2017,Sacramento Kings,109,Charlotte Hornets,106,3
1966,703,Sat Jan 28 2017,Golden State Warriors,144,Los Angeles Clippers,98,46
703,703,Sat Jan 28 2017,Los Angeles Clippers,98,Golden State Warriors,144,-46
1967,704,Sat Jan 28 2017,Miami Heat,116,Detroit Pistons,103,13
704,704,Sat Jan 28 2017,Detroit Pistons,103,Miami Heat,116,-13
1968,705,Sat Jan 28 2017,Milwaukee Bucks,108,Boston Celtics,112,-4
705,705,Sat Jan 28 2017,Boston Celtics,112,Milwaukee Bucks,108,4
1969,706,Sat Jan 28 2017,Minnesota Timberwolves,129,Brooklyn Nets,109,20
706,706,Sat Jan 28 2017,Brooklyn Nets,109,Minnesota Timberwolves,129,-20
1970,707,Sat Jan 28 2017,Phoenix Suns,112,Denver Nuggets,123,-11
707,707,Sat Jan 28 2017,Denver Nuggets,123,Phoenix Suns,112,11
1971,708,Sat Jan 28 2017,Utah Jazz,95,Memphis Grizzlies,102,-7
708,708,Sat Jan 28 2017,Memphis Grizzlies,102,Utah Jazz,95,7
1972,709,Sun Jan 29 2017,Atlanta Hawks,142,New York Knicks,139,3
709,709,Sun Jan 29 2017,New York Knicks,139,Atlanta Hawks,142,-3
1973,710,Sun Jan 29 2017,Chicago Bulls,121,Philadelphia 76ers,108,13
710,710,Sun Jan 29 2017,Philadelphia 76ers,108,Chicago Bulls,121,-13
1974,711,Sun Jan 29 2017,Cleveland Cavaliers,107,Oklahoma City Thunder,91,16
711,711,Sun Jan 29 2017,Oklahoma City Thunder,91,Cleveland Cavaliers,107,-16
1975,712,Sun Jan 29 2017,Indiana Pacers,120,Houston Rockets,101,19
712,712,Sun Jan 29 2017,Houston Rockets,101,Indiana Pacers,120,-19
1976,713,Sun Jan 29 2017,New Orleans Pelicans,94,Washington Wizards,107,-13
713,713,Sun Jan 29 2017,Washington Wizards,107,New Orleans Pelicans,94,13
1977,714,Sun Jan 29 2017,Portland Trail Blazers,111,Golden State Warriors,113,-2
714,714,Sun Jan 29 2017,Golden State Warriors,113,Portland Trail Blazers,111,2
1978,715,Sun Jan 29 2017,San Antonio Spurs,101,Dallas Mavericks,105,-4
715,715,Sun Jan 29 2017,Dallas Mavericks,105,San Antonio Spurs,101,4
1979,716,Sun Jan 29 2017,Toronto Raptors,113,Orlando Magic,114,-1
716,716,Sun Jan 29 2017,Orlando Magic,114,Toronto Raptors,113,1
1980,717,Mon Jan 30 2017,Boston Celtics,113,Detroit Pistons,109,4
717,717,Mon Jan 30 2017,Detroit Pistons,109,Boston Celtics,113,-4
1981,718,Mon Jan 30 2017,Dallas Mavericks,104,Cleveland Cavaliers,97,7
718,718,Mon Jan 30 2017,Cleveland Cavaliers,97,Dallas Mavericks,104,-7
1982,719,Mon Jan 30 2017,Miami Heat,104,Brooklyn Nets,96,8
719,719,Mon Jan 30 2017,Brooklyn Nets,96,Miami Heat,104,-8
1983,720,Mon Jan 30 2017,Minnesota Timberwolves,111,Orlando Magic,105,6
720,720,Mon Jan 30 2017,Orlando Magic,105,Minnesota Timberwolves,111,-6
1984,721,Mon Jan 30 2017,Philadelphia 76ers,122,Sacramento Kings,119,3
721,721,Mon Jan 30 2017,Sacramento Kings,119,Philadelphia 76ers,122,-3
1985,722,Mon Jan 30 2017,Phoenix Suns,96,Memphis Grizzlies,115,-19
722,722,Mon Jan 30 2017,Memphis Grizzlies,115,Phoenix Suns,96,19
1986,723,Tue Jan 31 2017,Houston Rockets,105,Sacramento Kings,83,22
723,723,Tue Jan 31 2017,Sacramento Kings,83,Houston Rockets,105,-22
724,724,Tue Jan 31 2017,Denver Nuggets,116,Los Angeles Lakers,120,-4
1987,724,Tue Jan 31 2017,Los Angeles Lakers,120,Denver Nuggets,116,4
1988,725,Tue Jan 31 2017,Portland Trail Blazers,115,Charlotte Hornets,98,17
725,725,Tue Jan 31 2017,Charlotte Hornets,98,Portland Trail Blazers,115,-17
1989,726,Tue Jan 31 2017,San Antonio Spurs,108,Oklahoma City Thunder,94,14
726,726,Tue Jan 31 2017,Oklahoma City Thunder,94,San Antonio Spurs,108,-14
1990,727,Tue Jan 31 2017,Toronto Raptors,108,New Orleans Pelicans,106,2
727,727,Tue Jan 31 2017,New Orleans Pelicans,106,Toronto Raptors,108,-2
728,728,Tue Jan 31 2017,New York Knicks,101,Washington Wizards,117,-16
1991,728,Tue Jan 31 2017,Washington Wizards,117,New York Knicks,101,16
729,729,Wed Feb 1 2017,Toronto Raptors,104,Boston Celtics,109,-5
1992,729,Wed Feb 1 2017,Boston Celtics,109,Toronto Raptors,104,5
1993,730,Wed Feb 1 2017,Brooklyn Nets,90,New York Knicks,95,-5
730,730,Wed Feb 1 2017,New York Knicks,95,Brooklyn Nets,90,5
731,731,Wed Feb 1 2017,Minnesota Timberwolves,97,Cleveland Cavaliers,125,-28
1994,731,Wed Feb 1 2017,Cleveland Cavaliers,125,Minnesota Timberwolves,97,28
732,732,Wed Feb 1 2017,Philadelphia 76ers,95,Dallas Mavericks,113,-18
1995,732,Wed Feb 1 2017,Dallas Mavericks,113,Philadelphia 76ers,95,18
1996,733,Wed Feb 1 2017,Denver Nuggets,99,Memphis Grizzlies,119,-20
733,733,Wed Feb 1 2017,Memphis Grizzlies,119,Denver Nuggets,99,20
1997,734,Wed Feb 1 2017,Detroit Pistons,118,New Orleans Pelicans,98,20
734,734,Wed Feb 1 2017,New Orleans Pelicans,98,Detroit Pistons,118,-20
1998,735,Wed Feb 1 2017,Golden State Warriors,126,Charlotte Hornets,111,15
735,735,Wed Feb 1 2017,Charlotte Hornets,111,Golden State Warriors,126,-15
736,736,Wed Feb 1 2017,Atlanta Hawks,93,Miami Heat,116,-23
1999,736,Wed Feb 1 2017,Miami Heat,116,Atlanta Hawks,93,23
2000,737,Wed Feb 1 2017,Oklahoma City Thunder,100,Chicago Bulls,128,-28
737,737,Wed Feb 1 2017,Chicago Bulls,128,Oklahoma City Thunder,100,28
2001,738,Wed Feb 1 2017,Orlando Magic,88,Indiana Pacers,98,-10
738,738,Wed Feb 1 2017,Indiana Pacers,98,Orlando Magic,88,10
739,739,Wed Feb 1 2017,Los Angeles Clippers,124,Phoenix Suns,114,10
2002,739,Wed Feb 1 2017,Phoenix Suns,114,Los Angeles Clippers,124,-10
2003,740,Wed Feb 1 2017,Utah Jazz,104,Milwaukee Bucks,88,16
740,740,Wed Feb 1 2017,Milwaukee Bucks,88,Utah Jazz,104,-16
741,741,Thu Feb 2 2017,Atlanta Hawks,113,Houston Rockets,108,5
2004,741,Thu Feb 2 2017,Houston Rockets,108,Atlanta Hawks,113,-5
2005,742,Thu Feb 2 2017,Los Angeles Clippers,120,Golden State Warriors,133,-13
742,742,Thu Feb 2 2017,Golden State Warriors,133,Los Angeles Clippers,120,13
743,743,Thu Feb 2 2017,Philadelphia 76ers,86,San Antonio Spurs,102,-16
2006,743,Thu Feb 2 2017,San Antonio Spurs,102,Philadelphia 76ers,86,16
2007,744,Thu Feb 2 2017,Washington Wizards,116,Los Angeles Lakers,108,8
744,744,Thu Feb 2 2017,Los Angeles Lakers,108,Washington Wizards,116,-8
745,745,Fri Feb 3 2017,Los Angeles Lakers,107,Boston Celtics,113,-6
2008,745,Fri Feb 3 2017,Boston Celtics,113,Los Angeles Lakers,107,6
746,746,Fri Feb 3 2017,Indiana Pacers,106,Brooklyn Nets,97,9
2009,746,Fri Feb 3 2017,Brooklyn Nets,97,Indiana Pacers,106,-9
747,747,Fri Feb 3 2017,Milwaukee Bucks,117,Denver Nuggets,121,-4
2010,747,Fri Feb 3 2017,Denver Nuggets,121,Milwaukee Bucks,117,4
2011,748,Fri Feb 3 2017,Detroit Pistons,116,Minnesota Timberwolves,108,8
748,748,Fri Feb 3 2017,Minnesota Timberwolves,108,Detroit Pistons,116,-8
749,749,Fri Feb 3 2017,Chicago Bulls,117,Houston Rockets,121,-4
2012,749,Fri Feb 3 2017,Houston Rockets,121,Chicago Bulls,117,4
750,750,Fri Feb 3 2017,Memphis Grizzlies,102,Oklahoma City Thunder,114,-12
2013,750,Fri Feb 3 2017,Oklahoma City Thunder,114,Memphis Grizzlies,102,12
2014,751,Fri Feb 3 2017,Orlando Magic,102,Toronto Raptors,94,8
751,751,Fri Feb 3 2017,Toronto Raptors,94,Orlando Magic,102,-8
2015,752,Fri Feb 3 2017,Portland Trail Blazers,104,Dallas Mavericks,108,-4
752,752,Fri Feb 3 2017,Dallas Mavericks,108,Portland Trail Blazers,104,4
753,753,Fri Feb 3 2017,Phoenix Suns,105,Sacramento Kings,103,2
2016,753,Fri Feb 3 2017,Sacramento Kings,103,Phoenix Suns,105,-2
754,754,Sat Feb 4 2017,Orlando Magic,86,Atlanta Hawks,113,-27
2017,754,Sat Feb 4 2017,Atlanta Hawks,113,Orlando Magic,86,27
755,755,Sat Feb 4 2017,Detroit Pistons,84,Indiana Pacers,105,-21
2018,755,Sat Feb 4 2017,Indiana Pacers,105,Detroit Pistons,84,21
2019,756,Sat Feb 4 2017,Miami Heat,125,Philadelphia 76ers,102,23
756,756,Sat Feb 4 2017,Philadelphia 76ers,102,Miami Heat,125,-23
757,757,Sat Feb 4 2017,Memphis Grizzlies,107,Minnesota Timberwolves,99,8
2020,757,Sat Feb 4 2017,Minnesota Timberwolves,99,Memphis Grizzlies,107,-8
758,758,Sat Feb 4 2017,Cleveland Cavaliers,111,New York Knicks,104,7
2021,758,Sat Feb 4 2017,New York Knicks,104,Cleveland Cavaliers,111,-7
2022,759,Sat Feb 4 2017,Phoenix Suns,112,Milwaukee Bucks,137,-25
759,759,Sat Feb 4 2017,Milwaukee Bucks,137,Phoenix Suns,112,25
760,760,Sat Feb 4 2017,Golden State Warriors,106,Sacramento Kings,109,-3
2023,760,Sat Feb 4 2017,Sacramento Kings,109,Golden State Warriors,106,3
761,761,Sat Feb 4 2017,Denver Nuggets,97,San Antonio Spurs,121,-24
2024,761,Sat Feb 4 2017,San Antonio Spurs,121,Denver Nuggets,97,24
762,762,Sat Feb 4 2017,Charlotte Hornets,98,Utah Jazz,105,-7
2025,762,Sat Feb 4 2017,Utah Jazz,105,Charlotte Hornets,98,7
763,763,Sat Feb 4 2017,New Orleans Pelicans,91,Washington Wizards,105,-14
2026,763,Sat Feb 4 2017,Washington Wizards,105,New Orleans Pelicans,91,14
2027,764,Sun Feb 5 2017,Boston Celtics,107,Los Angeles Clippers,102,5
764,764,Sun Feb 5 2017,Los Angeles Clippers,102,Boston Celtics,107,-5
2028,765,Sun Feb 5 2017,Brooklyn Nets,95,Toronto Raptors,103,-8
765,765,Sun Feb 5 2017,Toronto Raptors,103,Brooklyn Nets,95,8
2029,766,Sun Feb 5 2017,Oklahoma City Thunder,105,Portland Trail Blazers,99,6
766,766,Sun Feb 5 2017,Portland Trail Blazers,99,Oklahoma City Thunder,105,-6
767,767,Mon Feb 6 2017,Utah Jazz,120,Atlanta Hawks,95,25
2030,767,Mon Feb 6 2017,Atlanta Hawks,95,Utah Jazz,120,-25
768,768,Mon Feb 6 2017,Dallas Mavericks,87,Denver Nuggets,110,-23
2031,768,Mon Feb 6 2017,Denver Nuggets,110,Dallas Mavericks,87,23
769,769,Mon Feb 6 2017,Philadelphia 76ers,96,Detroit Pistons,113,-17
2032,769,Mon Feb 6 2017,Detroit Pistons,113,Philadelphia 76ers,96,17
770,770,Mon Feb 6 2017,Oklahoma City Thunder,90,Indiana Pacers,93,-3
2033,770,Mon Feb 6 2017,Indiana Pacers,93,Oklahoma City Thunder,90,3
2034,771,Mon Feb 6 2017,Memphis Grizzlies,89,San Antonio Spurs,74,15
771,771,Mon Feb 6 2017,San Antonio Spurs,74,Memphis Grizzlies,89,-15
2035,772,Mon Feb 6 2017,Minnesota Timberwolves,113,Miami Heat,115,-2
772,772,Mon Feb 6 2017,Miami Heat,115,Minnesota Timberwolves,113,2
2036,773,Mon Feb 6 2017,New Orleans Pelicans,111,Phoenix Suns,106,5
773,773,Mon Feb 6 2017,Phoenix Suns,106,New Orleans Pelicans,111,-5
774,774,Mon Feb 6 2017,Los Angeles Lakers,121,New York Knicks,107,14
2037,774,Mon Feb 6 2017,New York Knicks,107,Los Angeles Lakers,121,-14
2038,775,Mon Feb 6 2017,Sacramento Kings,107,Chicago Bulls,112,-5
775,775,Mon Feb 6 2017,Chicago Bulls,112,Sacramento Kings,107,5
776,776,Mon Feb 6 2017,Los Angeles Clippers,109,Toronto Raptors,118,-9
2039,776,Mon Feb 6 2017,Toronto Raptors,118,Los Angeles Clippers,109,9
2040,777,Mon Feb 6 2017,Washington Wizards,135,Cleveland Cavaliers,140,-5
777,777,Mon Feb 6 2017,Cleveland Cavaliers,140,Washington Wizards,135,5
778,778,Tue Feb 7 2017,Brooklyn Nets,107,Charlotte Hornets,111,-4
2041,778,Tue Feb 7 2017,Charlotte Hornets,111,Brooklyn Nets,107,4
2042,779,Tue Feb 7 2017,Dallas Mavericks,113,Portland Trail Blazers,114,-1
779,779,Tue Feb 7 2017,Portland Trail Blazers,114,Dallas Mavericks,113,1
2043,780,Tue Feb 7 2017,Houston Rockets,128,Orlando Magic,104,24
780,780,Tue Feb 7 2017,Orlando Magic,104,Houston Rockets,128,-24
2044,781,Wed Feb 8 2017,Atlanta Hawks,117,Denver Nuggets,106,11
781,781,Wed Feb 8 2017,Denver Nuggets,106,Atlanta Hawks,117,-11
2045,782,Wed Feb 8 2017,Brooklyn Nets,110,Washington Wizards,114,-4
782,782,Wed Feb 8 2017,Washington Wizards,114,Brooklyn Nets,110,4
783,783,Wed Feb 8 2017,Los Angeles Lakers,102,Detroit Pistons,121,-19
2046,783,Wed Feb 8 2017,Detroit Pistons,121,Los Angeles Lakers,102,19
784,784,Wed Feb 8 2017,Chicago Bulls,92,Golden State Warriors,123,-31
2047,784,Wed Feb 8 2017,Golden State Warriors,123,Chicago Bulls,92,31
785,785,Wed Feb 8 2017,Cleveland Cavaliers,132,Indiana Pacers,117,15
2048,785,Wed Feb 8 2017,Indiana Pacers,117,Cleveland Cavaliers,132,-15
2049,786,Wed Feb 8 2017,Memphis Grizzlies,110,Phoenix Suns,91,19
786,786,Wed Feb 8 2017,Phoenix Suns,91,Memphis Grizzlies,110,-19
787,787,Wed Feb 8 2017,Miami Heat,106,Milwaukee Bucks,88,18
2050,787,Wed Feb 8 2017,Milwaukee Bucks,88,Miami Heat,106,-18
2051,788,Wed Feb 8 2017,Minnesota Timberwolves,112,Toronto Raptors,109,3
788,788,Wed Feb 8 2017,Toronto Raptors,109,Minnesota Timberwolves,112,-3
789,789,Wed Feb 8 2017,Utah Jazz,127,New Orleans Pelicans,94,33
2052,789,Wed Feb 8 2017,New Orleans Pelicans,94,Utah Jazz,127,-33
790,790,Wed Feb 8 2017,Los Angeles Clippers,119,New York Knicks,115,4
2053,790,Wed Feb 8 2017,New York Knicks,115,Los Angeles Clippers,119,-4
791,791,Wed Feb 8 2017,San Antonio Spurs,111,Philadelphia 76ers,103,8
2054,791,Wed Feb 8 2017,Philadelphia 76ers,103,San Antonio Spurs,111,-8
792,792,Wed Feb 8 2017,Boston Celtics,92,Sacramento Kings,108,-16
2055,792,Wed Feb 8 2017,Sacramento Kings,108,Boston Celtics,92,16
793,793,Thu Feb 9 2017,Houston Rockets,107,Charlotte Hornets,95,12
2056,793,Thu Feb 9 2017,Charlotte Hornets,95,Houston Rockets,107,-12
794,794,Thu Feb 9 2017,Utah Jazz,105,Dallas Mavericks,112,-7
2057,794,Thu Feb 9 2017,Dallas Mavericks,112,Utah Jazz,105,7
795,795,Thu Feb 9 2017,Cleveland Cavaliers,109,Oklahoma City Thunder,118,-9
2058,795,Thu Feb 9 2017,Oklahoma City Thunder,118,Cleveland Cavaliers,109,9
2059,796,Thu Feb 9 2017,Orlando Magic,111,Philadelphia 76ers,112,-1
796,796,Thu Feb 9 2017,Philadelphia 76ers,112,Orlando Magic,111,1
797,797,Thu Feb 9 2017,Boston Celtics,120,Portland Trail Blazers,111,9
2060,797,Thu Feb 9 2017,Portland Trail Blazers,111,Boston Celtics,120,-9
798,798,Fri Feb 10 2017,Miami Heat,108,Brooklyn Nets,99,9
2061,798,Fri Feb 10 2017,Brooklyn Nets,99,Miami Heat,108,-9
2062,799,Fri Feb 10 2017,Detroit Pistons,92,San Antonio Spurs,103,-11
799,799,Fri Feb 10 2017,San Antonio Spurs,103,Detroit Pistons,92,11
2063,800,Fri Feb 10 2017,Memphis Grizzlies,107,Golden State Warriors,122,-15
800,800,Fri Feb 10 2017,Golden State Warriors,122,Memphis Grizzlies,107,15
801,801,Fri Feb 10 2017,Los Angeles Lakers,122,Milwaukee Bucks,114,8
2064,801,Fri Feb 10 2017,Milwaukee Bucks,114,Los Angeles Lakers,122,-8
2065,802,Fri Feb 10 2017,Minnesota Timberwolves,106,New Orleans Pelicans,122,-16
802,802,Fri Feb 10 2017,New Orleans Pelicans,122,Minnesota Timberwolves,106,16
2066,803,Fri Feb 10 2017,New York Knicks,123,Denver Nuggets,131,-8
803,803,Fri Feb 10 2017,Denver Nuggets,131,New York Knicks,123,8
2067,804,Fri Feb 10 2017,Phoenix Suns,115,Chicago Bulls,97,18
804,804,Fri Feb 10 2017,Chicago Bulls,97,Phoenix Suns,115,-18
2068,805,Fri Feb 10 2017,Sacramento Kings,108,Atlanta Hawks,107,1
805,805,Fri Feb 10 2017,Atlanta Hawks,107,Sacramento Kings,108,-1
2069,806,Fri Feb 10 2017,Washington Wizards,112,Indiana Pacers,107,5
806,806,Fri Feb 10 2017,Indiana Pacers,107,Washington Wizards,112,-5
2070,807,Sat Feb 11 2017,Charlotte Hornets,102,Los Angeles Clippers,107,-5
807,807,Sat Feb 11 2017,Los Angeles Clippers,107,Charlotte Hornets,102,5
2071,808,Sat Feb 11 2017,Cleveland Cavaliers,125,Denver Nuggets,109,16
808,808,Sat Feb 11 2017,Denver Nuggets,109,Cleveland Cavaliers,125,-16
2072,809,Sat Feb 11 2017,Dallas Mavericks,112,Orlando Magic,80,32
809,809,Sat Feb 11 2017,Orlando Magic,80,Dallas Mavericks,112,-32
810,810,Sat Feb 11 2017,Phoenix Suns,102,Houston Rockets,133,-31
2073,810,Sat Feb 11 2017,Houston Rockets,133,Phoenix Suns,102,31
2074,811,Sat Feb 11 2017,Indiana Pacers,100,Milwaukee Bucks,116,-16
811,811,Sat Feb 11 2017,Milwaukee Bucks,116,Indiana Pacers,100,16
812,812,Sat Feb 11 2017,Golden State Warriors,130,Oklahoma City Thunder,114,16
2075,812,Sat Feb 11 2017,Oklahoma City Thunder,114,Golden State Warriors,130,-16
813,813,Sat Feb 11 2017,Miami Heat,109,Philadelphia 76ers,117,-8
2076,813,Sat Feb 11 2017,Philadelphia 76ers,117,Miami Heat,109,8
2077,814,Sat Feb 11 2017,Utah Jazz,104,Boston Celtics,112,-8
814,814,Sat Feb 11 2017,Boston Celtics,112,Utah Jazz,104,8
815,815,Sun Feb 12 2017,Chicago Bulls,89,Minnesota Timberwolves,117,-28
2078,815,Sun Feb 12 2017,Minnesota Timberwolves,117,Chicago Bulls,89,28
2079,816,Sun Feb 12 2017,New York Knicks,94,San Antonio Spurs,90,4
816,816,Sun Feb 12 2017,San Antonio Spurs,90,New York Knicks,94,-4
2080,817,Sun Feb 12 2017,Sacramento Kings,105,New Orleans Pelicans,99,6
817,817,Sun Feb 12 2017,New Orleans Pelicans,99,Sacramento Kings,105,-6
2081,818,Sun Feb 12 2017,Toronto Raptors,101,Detroit Pistons,102,-1
818,818,Sun Feb 12 2017,Detroit Pistons,102,Toronto Raptors,101,1
2082,819,Mon Feb 13 2017,Brooklyn Nets,103,Memphis Grizzlies,112,-9
819,819,Mon Feb 13 2017,Memphis Grizzlies,112,Brooklyn Nets,103,9
2083,820,Mon Feb 13 2017,Charlotte Hornets,99,Philadelphia 76ers,105,-6
820,820,Mon Feb 13 2017,Philadelphia 76ers,105,Charlotte Hornets,99,6
2084,821,Mon Feb 13 2017,Dallas Mavericks,98,Boston Celtics,111,-13
821,821,Mon Feb 13 2017,Boston Celtics,111,Dallas Mavericks,98,13
822,822,Mon Feb 13 2017,Golden State Warriors,110,Denver Nuggets,132,-22
2085,822,Mon Feb 13 2017,Denver Nuggets,132,Golden State Warriors,110,22
823,823,Mon Feb 13 2017,San Antonio Spurs,110,Indiana Pacers,106,4
2086,823,Mon Feb 13 2017,Indiana Pacers,106,San Antonio Spurs,110,-4
824,824,Mon Feb 13 2017,Orlando Magic,116,Miami Heat,107,9
2087,824,Mon Feb 13 2017,Miami Heat,107,Orlando Magic,116,-9
2088,825,Mon Feb 13 2017,Milwaukee Bucks,102,Detroit Pistons,89,13
825,825,Mon Feb 13 2017,Detroit Pistons,89,Milwaukee Bucks,102,-13
826,826,Mon Feb 13 2017,New Orleans Pelicans,110,Phoenix Suns,108,2
2089,826,Mon Feb 13 2017,Phoenix Suns,108,New Orleans Pelicans,110,-2
2090,827,Mon Feb 13 2017,Portland Trail Blazers,104,Atlanta Hawks,109,-5
827,827,Mon Feb 13 2017,Atlanta Hawks,109,Portland Trail Blazers,104,5
2091,828,Mon Feb 13 2017,Utah Jazz,72,Los Angeles Clippers,88,-16
828,828,Mon Feb 13 2017,Los Angeles Clippers,88,Utah Jazz,72,16
2092,829,Mon Feb 13 2017,Washington Wizards,120,Oklahoma City Thunder,98,22
829,829,Mon Feb 13 2017,Oklahoma City Thunder,98,Washington Wizards,120,-22
830,830,Tue Feb 14 2017,Toronto Raptors,94,Chicago Bulls,105,-11
2093,830,Tue Feb 14 2017,Chicago Bulls,105,Toronto Raptors,94,11
831,831,Tue Feb 14 2017,Sacramento Kings,97,Los Angeles Lakers,96,1
2094,831,Tue Feb 14 2017,Los Angeles Lakers,96,Sacramento Kings,97,-1
2095,832,Tue Feb 14 2017,Minnesota Timberwolves,108,Cleveland Cavaliers,116,-8
832,832,Tue Feb 14 2017,Cleveland Cavaliers,116,Minnesota Timberwolves,108,8
2096,833,Wed Feb 15 2017,Boston Celtics,116,Philadelphia 76ers,108,8
833,833,Wed Feb 15 2017,Philadelphia 76ers,108,Boston Celtics,116,-8
2097,834,Wed Feb 15 2017,Brooklyn Nets,125,Milwaukee Bucks,129,-4
834,834,Wed Feb 15 2017,Milwaukee Bucks,129,Brooklyn Nets,125,4
2098,835,Wed Feb 15 2017,Cleveland Cavaliers,113,Indiana Pacers,104,9
835,835,Wed Feb 15 2017,Indiana Pacers,104,Cleveland Cavaliers,113,-9
836,836,Wed Feb 15 2017,Minnesota Timberwolves,112,Denver Nuggets,99,13
2099,836,Wed Feb 15 2017,Denver Nuggets,99,Minnesota Timberwolves,112,-13
2100,837,Wed Feb 15 2017,Detroit Pistons,98,Dallas Mavericks,91,7
837,837,Wed Feb 15 2017,Dallas Mavericks,91,Detroit Pistons,98,-7
838,838,Wed Feb 15 2017,Sacramento Kings,86,Golden State Warriors,109,-23
2101,838,Wed Feb 15 2017,Golden State Warriors,109,Sacramento Kings,86,23
839,839,Wed Feb 15 2017,Miami Heat,117,Houston Rockets,109,8
2102,839,Wed Feb 15 2017,Houston Rockets,109,Miami Heat,117,-8
2103,840,Wed Feb 15 2017,Los Angeles Clippers,99,Atlanta Hawks,84,15
840,840,Wed Feb 15 2017,Atlanta Hawks,84,Los Angeles Clippers,99,-15
2104,841,Wed Feb 15 2017,Memphis Grizzlies,91,New Orleans Pelicans,95,-4
841,841,Wed Feb 15 2017,New Orleans Pelicans,95,Memphis Grizzlies,91,4
2105,842,Wed Feb 15 2017,Oklahoma City Thunder,116,New York Knicks,105,11
842,842,Wed Feb 15 2017,New York Knicks,105,Oklahoma City Thunder,116,-11
843,843,Wed Feb 15 2017,San Antonio Spurs,107,Orlando Magic,79,28
2106,843,Wed Feb 15 2017,Orlando Magic,79,San Antonio Spurs,107,-28
2107,844,Wed Feb 15 2017,Phoenix Suns,137,Los Angeles Lakers,101,36
844,844,Wed Feb 15 2017,Los Angeles Lakers,101,Phoenix Suns,137,-36
845,845,Wed Feb 15 2017,Charlotte Hornets,85,Toronto Raptors,90,-5
2108,845,Wed Feb 15 2017,Toronto Raptors,90,Charlotte Hornets,85,5
2109,846,Wed Feb 15 2017,Utah Jazz,111,Portland Trail Blazers,88,23
846,846,Wed Feb 15 2017,Portland Trail Blazers,88,Utah Jazz,111,-23
847,847,Thu Feb 16 2017,Boston Celtics,103,Chicago Bulls,104,-1
2110,847,Thu Feb 16 2017,Chicago Bulls,104,Boston Celtics,103,1
2111,848,Thu Feb 16 2017,Indiana Pacers,98,Washington Wizards,111,-13
848,848,Thu Feb 16 2017,Washington Wizards,111,Indiana Pacers,98,13
2112,849,Thu Feb 23 2017,Cleveland Cavaliers,119,New York Knicks,104,15
849,849,Thu Feb 23 2017,New York Knicks,104,Cleveland Cavaliers,119,-15
850,850,Thu Feb 23 2017,Charlotte Hornets,108,Detroit Pistons,114,-6
2113,850,Thu Feb 23 2017,Detroit Pistons,114,Charlotte Hornets,108,6
851,851,Thu Feb 23 2017,Los Angeles Clippers,113,Golden State Warriors,123,-10
2114,851,Thu Feb 23 2017,Golden State Warriors,123,Los Angeles Clippers,113,10
2115,852,Thu Feb 23 2017,New Orleans Pelicans,99,Houston Rockets,129,-30
852,852,Thu Feb 23 2017,Houston Rockets,129,New Orleans Pelicans,99,30
2116,853,Thu Feb 23 2017,Orlando Magic,103,Portland Trail Blazers,112,-9
853,853,Thu Feb 23 2017,Portland Trail Blazers,112,Orlando Magic,103,9
854,854,Thu Feb 23 2017,Denver Nuggets,100,Sacramento Kings,116,-16
2117,854,Thu Feb 23 2017,Sacramento Kings,116,Denver Nuggets,100,16
855,855,Fri Feb 24 2017,Miami Heat,108,Atlanta Hawks,90,18
2118,855,Fri Feb 24 2017,Atlanta Hawks,90,Miami Heat,108,-18
856,856,Fri Feb 24 2017,Phoenix Suns,121,Chicago Bulls,128,-7
2119,856,Fri Feb 24 2017,Chicago Bulls,128,Phoenix Suns,121,7
857,857,Fri Feb 24 2017,Brooklyn Nets,109,Denver Nuggets,129,-20
2120,857,Fri Feb 24 2017,Denver Nuggets,129,Brooklyn Nets,109,20
858,858,Fri Feb 24 2017,Memphis Grizzlies,92,Indiana Pacers,102,-10
2121,858,Fri Feb 24 2017,Indiana Pacers,102,Memphis Grizzlies,92,10
859,859,Fri Feb 24 2017,San Antonio Spurs,105,Los Angeles Clippers,97,8
2122,859,Fri Feb 24 2017,Los Angeles Clippers,97,San Antonio Spurs,105,-8
2123,860,Fri Feb 24 2017,Milwaukee Bucks,95,Utah Jazz,109,-14
860,860,Fri Feb 24 2017,Utah Jazz,109,Milwaukee Bucks,95,14
2124,861,Fri Feb 24 2017,Minnesota Timberwolves,97,Dallas Mavericks,84,13
861,861,Fri Feb 24 2017,Dallas Mavericks,84,Minnesota Timberwolves,97,-13
2125,862,Fri Feb 24 2017,Oklahoma City Thunder,110,Los Angeles Lakers,93,17
862,862,Fri Feb 24 2017,Los Angeles Lakers,93,Oklahoma City Thunder,110,-17
863,863,Fri Feb 24 2017,Washington Wizards,112,Philadelphia 76ers,120,-8
2126,863,Fri Feb 24 2017,Philadelphia 76ers,120,Washington Wizards,112,8
864,864,Fri Feb 24 2017,Boston Celtics,97,Toronto Raptors,107,-10
2127,864,Fri Feb 24 2017,Toronto Raptors,107,Boston Celtics,97,10
865,865,Sat Feb 25 2017,Chicago Bulls,117,Cleveland Cavaliers,99,18
2128,865,Sat Feb 25 2017,Cleveland Cavaliers,99,Chicago Bulls,117,-18
866,866,Sat Feb 25 2017,New Orleans Pelicans,83,Dallas Mavericks,96,-13
2129,866,Sat Feb 25 2017,Dallas Mavericks,96,New Orleans Pelicans,83,13
867,867,Sat Feb 25 2017,Brooklyn Nets,95,Golden State Warriors,112,-17
2130,867,Sat Feb 25 2017,Golden State Warriors,112,Brooklyn Nets,95,17
2131,868,Sat Feb 25 2017,Houston Rockets,142,Minnesota Timberwolves,130,12
868,868,Sat Feb 25 2017,Minnesota Timberwolves,130,Houston Rockets,142,-12
869,869,Sat Feb 25 2017,Indiana Pacers,95,Miami Heat,113,-18
2132,869,Sat Feb 25 2017,Miami Heat,113,Indiana Pacers,95,18
870,870,Sat Feb 25 2017,Philadelphia 76ers,109,New York Knicks,110,-1
2133,870,Sat Feb 25 2017,New York Knicks,110,Philadelphia 76ers,109,1
871,871,Sat Feb 25 2017,Atlanta Hawks,86,Orlando Magic,105,-19
2134,871,Sat Feb 25 2017,Orlando Magic,105,Atlanta Hawks,86,19
2135,872,Sat Feb 25 2017,Sacramento Kings,85,Charlotte Hornets,99,-14
872,872,Sat Feb 25 2017,Charlotte Hornets,99,Sacramento Kings,85,14
2136,873,Sun Feb 26 2017,Denver Nuggets,98,Memphis Grizzlies,105,-7
873,873,Sun Feb 26 2017,Memphis Grizzlies,105,Denver Nuggets,98,7
2137,874,Sun Feb 26 2017,Detroit Pistons,98,Boston Celtics,104,-6
874,874,Sun Feb 26 2017,Boston Celtics,104,Detroit Pistons,98,6
875,875,Sun Feb 26 2017,Charlotte Hornets,121,Los Angeles Clippers,124,-3
2138,875,Sun Feb 26 2017,Los Angeles Clippers,124,Charlotte Hornets,121,3
2139,876,Sun Feb 26 2017,Los Angeles Lakers,98,San Antonio Spurs,119,-21
876,876,Sun Feb 26 2017,San Antonio Spurs,119,Los Angeles Lakers,98,21
877,877,Sun Feb 26 2017,Phoenix Suns,96,Milwaukee Bucks,100,-4
2140,877,Sun Feb 26 2017,Milwaukee Bucks,100,Phoenix Suns,96,4
878,878,Sun Feb 26 2017,New Orleans Pelicans,110,Oklahoma City Thunder,118,-8
2141,878,Sun Feb 26 2017,Oklahoma City Thunder,118,New Orleans Pelicans,110,8
879,879,Sun Feb 26 2017,Portland Trail Blazers,106,Toronto Raptors,112,-6
2142,879,Sun Feb 26 2017,Toronto Raptors,112,Portland Trail Blazers,106,6
880,880,Sun Feb 26 2017,Utah Jazz,102,Washington Wizards,92,10
2143,880,Sun Feb 26 2017,Washington Wizards,92,Utah Jazz,102,-10
881,881,Mon Feb 27 2017,Atlanta Hawks,114,Boston Celtics,98,16
2144,881,Mon Feb 27 2017,Boston Celtics,98,Atlanta Hawks,114,-16
2145,882,Mon Feb 27 2017,Cleveland Cavaliers,102,Milwaukee Bucks,95,7
882,882,Mon Feb 27 2017,Milwaukee Bucks,95,Cleveland Cavaliers,102,-7
2146,883,Mon Feb 27 2017,Dallas Mavericks,96,Miami Heat,89,7
883,883,Mon Feb 27 2017,Miami Heat,89,Dallas Mavericks,96,-7
2147,884,Mon Feb 27 2017,Houston Rockets,108,Indiana Pacers,117,-9
884,884,Mon Feb 27 2017,Indiana Pacers,117,Houston Rockets,108,9
885,885,Mon Feb 27 2017,Toronto Raptors,92,New York Knicks,91,1
2148,885,Mon Feb 27 2017,New York Knicks,91,Toronto Raptors,92,-1
886,886,Mon Feb 27 2017,Golden State Warriors,119,Philadelphia 76ers,108,11
2149,886,Mon Feb 27 2017,Philadelphia 76ers,108,Golden State Warriors,119,-11
2150,887,Mon Feb 27 2017,Sacramento Kings,88,Minnesota Timberwolves,102,-14
887,887,Mon Feb 27 2017,Minnesota Timberwolves,102,Sacramento Kings,88,14
2151,888,Tue Feb 28 2017,Chicago Bulls,107,Denver Nuggets,125,-18
888,888,Tue Feb 28 2017,Denver Nuggets,125,Chicago Bulls,107,18
2152,889,Tue Feb 28 2017,Detroit Pistons,120,Portland Trail Blazers,113,7
889,889,Tue Feb 28 2017,Portland Trail Blazers,113,Detroit Pistons,120,-7
890,890,Tue Feb 28 2017,Charlotte Hornets,109,Los Angeles Lakers,104,5
2153,890,Tue Feb 28 2017,Los Angeles Lakers,104,Charlotte Hornets,109,-5
2154,891,Tue Feb 28 2017,Memphis Grizzlies,130,Phoenix Suns,112,18
891,891,Tue Feb 28 2017,Phoenix Suns,112,Memphis Grizzlies,130,-18
2155,892,Tue Feb 28 2017,Oklahoma City Thunder,109,Utah Jazz,106,3
892,892,Tue Feb 28 2017,Utah Jazz,106,Oklahoma City Thunder,109,-3
2156,893,Tue Feb 28 2017,Washington Wizards,112,Golden State Warriors,108,4
893,893,Tue Feb 28 2017,Golden State Warriors,108,Washington Wizards,112,-4
2157,894,Wed Mar 1 2017,Atlanta Hawks,100,Dallas Mavericks,95,5
894,894,Wed Mar 1 2017,Dallas Mavericks,95,Atlanta Hawks,100,-5
2158,895,Wed Mar 1 2017,Boston Celtics,103,Cleveland Cavaliers,99,4
895,895,Wed Mar 1 2017,Cleveland Cavaliers,99,Boston Celtics,103,-4
2159,896,Wed Mar 1 2017,Los Angeles Clippers,103,Houston Rockets,122,-19
896,896,Wed Mar 1 2017,Houston Rockets,122,Los Angeles Clippers,103,19
2160,897,Wed Mar 1 2017,Miami Heat,125,Philadelphia 76ers,98,27
897,897,Wed Mar 1 2017,Philadelphia 76ers,98,Miami Heat,125,-27
2161,898,Wed Mar 1 2017,Milwaukee Bucks,98,Denver Nuggets,110,-12
898,898,Wed Mar 1 2017,Denver Nuggets,110,Milwaukee Bucks,98,12
2162,899,Wed Mar 1 2017,New Orleans Pelicans,109,Detroit Pistons,86,23
899,899,Wed Mar 1 2017,Detroit Pistons,86,New Orleans Pelicans,109,-23
2163,900,Wed Mar 1 2017,Orlando Magic,90,New York Knicks,101,-11
900,900,Wed Mar 1 2017,New York Knicks,101,Orlando Magic,90,11
901,901,Wed Mar 1 2017,Brooklyn Nets,109,Sacramento Kings,100,9
2164,901,Wed Mar 1 2017,Sacramento Kings,100,Brooklyn Nets,109,-9
2165,902,Wed Mar 1 2017,San Antonio Spurs,100,Indiana Pacers,99,1
902,902,Wed Mar 1 2017,Indiana Pacers,99,San Antonio Spurs,100,-1
2166,903,Wed Mar 1 2017,Toronto Raptors,96,Washington Wizards,105,-9
903,903,Wed Mar 1 2017,Washington Wizards,105,Toronto Raptors,96,9
2167,904,Wed Mar 1 2017,Utah Jazz,80,Minnesota Timberwolves,107,-27
904,904,Wed Mar 1 2017,Minnesota Timberwolves,107,Utah Jazz,80,27
2168,905,Thu Mar 2 2017,Chicago Bulls,94,Golden State Warriors,87,7
905,905,Thu Mar 2 2017,Golden State Warriors,87,Chicago Bulls,94,-7
2169,906,Thu Mar 2 2017,Phoenix Suns,120,Charlotte Hornets,103,17
906,906,Thu Mar 2 2017,Charlotte Hornets,103,Phoenix Suns,120,-17
2170,907,Thu Mar 2 2017,Portland Trail Blazers,114,Oklahoma City Thunder,109,5
907,907,Thu Mar 2 2017,Oklahoma City Thunder,109,Portland Trail Blazers,114,-5
908,908,Fri Mar 3 2017,Cleveland Cavaliers,135,Atlanta Hawks,130,5
2171,908,Fri Mar 3 2017,Atlanta Hawks,130,Cleveland Cavaliers,135,-5
909,909,Fri Mar 3 2017,Memphis Grizzlies,100,Dallas Mavericks,104,-4
2172,909,Fri Mar 3 2017,Dallas Mavericks,104,Memphis Grizzlies,100,4
910,910,Fri Mar 3 2017,Boston Celtics,115,Los Angeles Lakers,95,20
2173,910,Fri Mar 3 2017,Los Angeles Lakers,95,Boston Celtics,115,-20
911,911,Fri Mar 3 2017,Los Angeles Clippers,101,Milwaukee Bucks,112,-11
2174,911,Fri Mar 3 2017,Milwaukee Bucks,112,Los Angeles Clippers,101,11
912,912,Fri Mar 3 2017,San Antonio Spurs,101,New Orleans Pelicans,98,3
2175,912,Fri Mar 3 2017,New Orleans Pelicans,98,San Antonio Spurs,101,-3
2176,913,Fri Mar 3 2017,Orlando Magic,110,Miami Heat,99,11
913,913,Fri Mar 3 2017,Miami Heat,99,Orlando Magic,110,-11
914,914,Fri Mar 3 2017,New York Knicks,102,Philadelphia 76ers,105,-3
2177,914,Fri Mar 3 2017,Philadelphia 76ers,105,New York Knicks,102,3
915,915,Fri Mar 3 2017,Oklahoma City Thunder,111,Phoenix Suns,118,-7
2178,915,Fri Mar 3 2017,Phoenix Suns,118,Oklahoma City Thunder,111,7
916,916,Fri Mar 3 2017,Brooklyn Nets,97,Utah Jazz,112,-15
2179,916,Fri Mar 3 2017,Utah Jazz,112,Brooklyn Nets,97,15
917,917,Fri Mar 3 2017,Toronto Raptors,114,Washington Wizards,106,8
2180,917,Fri Mar 3 2017,Washington Wizards,106,Toronto Raptors,114,-8
2181,918,Sat Mar 4 2017,Chicago Bulls,91,Los Angeles Clippers,101,-10
918,918,Sat Mar 4 2017,Los Angeles Clippers,101,Chicago Bulls,91,10
919,919,Sat Mar 4 2017,Charlotte Hornets,112,Denver Nuggets,102,10
2182,919,Sat Mar 4 2017,Denver Nuggets,102,Charlotte Hornets,112,-10
2183,920,Sat Mar 4 2017,Houston Rockets,123,Memphis Grizzlies,108,15
920,920,Sat Mar 4 2017,Memphis Grizzlies,108,Houston Rockets,123,-15
2184,921,Sat Mar 4 2017,Miami Heat,120,Cleveland Cavaliers,92,28
921,921,Sat Mar 4 2017,Cleveland Cavaliers,92,Miami Heat,120,-28
2185,922,Sat Mar 4 2017,Milwaukee Bucks,101,Toronto Raptors,94,7
922,922,Sat Mar 4 2017,Toronto Raptors,94,Milwaukee Bucks,101,-7
2186,923,Sat Mar 4 2017,Philadelphia 76ers,106,Detroit Pistons,136,-30
923,923,Sat Mar 4 2017,Detroit Pistons,136,Philadelphia 76ers,106,30
924,924,Sat Mar 4 2017,Brooklyn Nets,116,Portland Trail Blazers,130,-14
2187,924,Sat Mar 4 2017,Portland Trail Blazers,130,Brooklyn Nets,116,14
925,925,Sat Mar 4 2017,Minnesota Timberwolves,90,San Antonio Spurs,97,-7
2188,925,Sat Mar 4 2017,San Antonio Spurs,97,Minnesota Timberwolves,90,7
926,926,Sun Mar 5 2017,Indiana Pacers,97,Atlanta Hawks,96,1
2189,926,Sun Mar 5 2017,Atlanta Hawks,96,Indiana Pacers,97,-1
927,927,Sun Mar 5 2017,Oklahoma City Thunder,89,Dallas Mavericks,104,-15
2190,927,Sun Mar 5 2017,Dallas Mavericks,104,Oklahoma City Thunder,89,15
928,928,Sun Mar 5 2017,New Orleans Pelicans,105,Los Angeles Lakers,97,8
2191,928,Sun Mar 5 2017,Los Angeles Lakers,97,New Orleans Pelicans,105,-8
929,929,Sun Mar 5 2017,Golden State Warriors,112,New York Knicks,105,7
2192,929,Sun Mar 5 2017,New York Knicks,105,Golden State Warriors,112,-7
930,930,Sun Mar 5 2017,Boston Celtics,106,Phoenix Suns,109,-3
2193,930,Sun Mar 5 2017,Phoenix Suns,109,Boston Celtics,106,3
931,931,Sun Mar 5 2017,Utah Jazz,110,Sacramento Kings,109,1
2194,931,Sun Mar 5 2017,Sacramento Kings,109,Utah Jazz,110,-1
932,932,Sun Mar 5 2017,Orlando Magic,114,Washington Wizards,115,-1
2195,932,Sun Mar 5 2017,Washington Wizards,115,Orlando Magic,114,1
2196,933,Mon Mar 6 2017,Atlanta Hawks,111,Golden State Warriors,119,-8
933,933,Mon Mar 6 2017,Golden State Warriors,119,Atlanta Hawks,111,8
934,934,Mon Mar 6 2017,Indiana Pacers,88,Charlotte Hornets,100,-12
2197,934,Mon Mar 6 2017,Charlotte Hornets,100,Indiana Pacers,88,12
2198,935,Mon Mar 6 2017,Cleveland Cavaliers,98,Miami Heat,106,-8
935,935,Mon Mar 6 2017,Miami Heat,106,Cleveland Cavaliers,98,8
2199,936,Mon Mar 6 2017,Denver Nuggets,108,Sacramento Kings,96,12
936,936,Mon Mar 6 2017,Sacramento Kings,96,Denver Nuggets,108,-12
2200,937,Mon Mar 6 2017,Detroit Pistons,109,Chicago Bulls,95,14
937,937,Mon Mar 6 2017,Chicago Bulls,95,Detroit Pistons,109,-14
938,938,Mon Mar 6 2017,Boston Celtics,102,Los Angeles Clippers,116,-14
2201,938,Mon Mar 6 2017,Los Angeles Clippers,116,Boston Celtics,102,14
2202,939,Mon Mar 6 2017,Memphis Grizzlies,109,Brooklyn Nets,122,-13
939,939,Mon Mar 6 2017,Brooklyn Nets,122,Memphis Grizzlies,109,13
2203,940,Mon Mar 6 2017,Orlando Magic,105,New York Knicks,113,-8
940,940,Mon Mar 6 2017,New York Knicks,113,Orlando Magic,105,8
941,941,Mon Mar 6 2017,Milwaukee Bucks,112,Philadelphia 76ers,98,14
2204,941,Mon Mar 6 2017,Philadelphia 76ers,98,Milwaukee Bucks,112,-14
942,942,Mon Mar 6 2017,Houston Rockets,110,San Antonio Spurs,112,-2
2205,942,Mon Mar 6 2017,San Antonio Spurs,112,Houston Rockets,110,2
943,943,Mon Mar 6 2017,New Orleans Pelicans,83,Utah Jazz,88,-5
2206,943,Mon Mar 6 2017,Utah Jazz,88,New Orleans Pelicans,83,5
944,944,Tue Mar 7 2017,Los Angeles Lakers,111,Dallas Mavericks,122,-11
2207,944,Tue Mar 7 2017,Dallas Mavericks,122,Los Angeles Lakers,111,11
945,945,Tue Mar 7 2017,Portland Trail Blazers,126,Oklahoma City Thunder,121,5
2208,945,Tue Mar 7 2017,Oklahoma City Thunder,121,Portland Trail Blazers,126,-5
946,946,Tue Mar 7 2017,Washington Wizards,131,Phoenix Suns,127,4
2209,946,Tue Mar 7 2017,Phoenix Suns,127,Washington Wizards,131,-4
2210,947,Wed Mar 8 2017,Atlanta Hawks,110,Brooklyn Nets,105,5
947,947,Wed Mar 8 2017,Brooklyn Nets,105,Atlanta Hawks,110,-5
2211,948,Wed Mar 8 2017,Denver Nuggets,113,Washington Wizards,123,-10
948,948,Wed Mar 8 2017,Washington Wizards,123,Denver Nuggets,113,10
949,949,Wed Mar 8 2017,Boston Celtics,99,Golden State Warriors,86,13
2212,949,Wed Mar 8 2017,Golden State Warriors,86,Boston Celtics,99,-13
950,950,Wed Mar 8 2017,Utah Jazz,115,Houston Rockets,108,7
2213,950,Wed Mar 8 2017,Houston Rockets,108,Utah Jazz,115,-7
951,951,Wed Mar 8 2017,Detroit Pistons,98,Indiana Pacers,115,-17
2214,951,Wed Mar 8 2017,Indiana Pacers,115,Detroit Pistons,98,17
2215,952,Wed Mar 8 2017,Miami Heat,108,Charlotte Hornets,101,7
952,952,Wed Mar 8 2017,Charlotte Hornets,101,Miami Heat,108,-7
953,953,Wed Mar 8 2017,New York Knicks,93,Milwaukee Bucks,104,-11
2216,953,Wed Mar 8 2017,Milwaukee Bucks,104,New York Knicks,93,11
2217,954,Wed Mar 8 2017,Minnesota Timberwolves,107,Los Angeles Clippers,91,16
954,954,Wed Mar 8 2017,Los Angeles Clippers,91,Minnesota Timberwolves,107,-16
2218,955,Wed Mar 8 2017,New Orleans Pelicans,87,Toronto Raptors,94,-7
955,955,Wed Mar 8 2017,Toronto Raptors,94,New Orleans Pelicans,87,7
956,956,Wed Mar 8 2017,Chicago Bulls,91,Orlando Magic,98,-7
2219,956,Wed Mar 8 2017,Orlando Magic,98,Chicago Bulls,91,7
957,957,Wed Mar 8 2017,Sacramento Kings,104,San Antonio Spurs,114,-10
2220,957,Wed Mar 8 2017,San Antonio Spurs,114,Sacramento Kings,104,10
958,958,Thu Mar 9 2017,Cleveland Cavaliers,101,Detroit Pistons,106,-5
2221,958,Thu Mar 9 2017,Detroit Pistons,106,Cleveland Cavaliers,101,5
959,959,Thu Mar 9 2017,Los Angeles Clippers,114,Memphis Grizzlies,98,16
2222,959,Thu Mar 9 2017,Memphis Grizzlies,98,Los Angeles Clippers,114,-16
960,960,Thu Mar 9 2017,San Antonio Spurs,92,Oklahoma City Thunder,102,-10
2223,960,Thu Mar 9 2017,Oklahoma City Thunder,102,San Antonio Spurs,92,10
2224,961,Thu Mar 9 2017,Phoenix Suns,110,Los Angeles Lakers,122,-12
961,961,Thu Mar 9 2017,Los Angeles Lakers,122,Phoenix Suns,110,12
2225,962,Thu Mar 9 2017,Portland Trail Blazers,114,Philadelphia 76ers,108,6
962,962,Thu Mar 9 2017,Philadelphia 76ers,108,Portland Trail Blazers,114,-6
963,963,Fri Mar 10 2017,Toronto Raptors,99,Atlanta Hawks,105,-6
2226,963,Fri Mar 10 2017,Atlanta Hawks,105,Toronto Raptors,99,6
2227,964,Fri Mar 10 2017,Chicago Bulls,94,Houston Rockets,115,-21
964,964,Fri Mar 10 2017,Houston Rockets,115,Chicago Bulls,94,21
965,965,Fri Mar 10 2017,Orlando Magic,81,Charlotte Hornets,121,-40
2228,965,Fri Mar 10 2017,Charlotte Hornets,121,Orlando Magic,81,40
2229,966,Fri Mar 10 2017,Dallas Mavericks,105,Brooklyn Nets,96,9
966,966,Fri Mar 10 2017,Brooklyn Nets,96,Dallas Mavericks,105,-9
967,967,Fri Mar 10 2017,Boston Celtics,99,Denver Nuggets,119,-20
2230,967,Fri Mar 10 2017,Denver Nuggets,119,Boston Celtics,99,20
2231,968,Fri Mar 10 2017,Milwaukee Bucks,99,Indiana Pacers,85,14
968,968,Fri Mar 10 2017,Indiana Pacers,85,Milwaukee Bucks,99,-14
2232,969,Fri Mar 10 2017,Minnesota Timberwolves,103,Golden State Warriors,102,1
969,969,Fri Mar 10 2017,Golden State Warriors,102,Minnesota Timberwolves,103,-1
2233,970,Fri Mar 10 2017,Sacramento Kings,122,Washington Wizards,130,-8
970,970,Fri Mar 10 2017,Washington Wizards,130,Sacramento Kings,122,8
2234,971,Sat Mar 11 2017,Charlotte Hornets,122,New Orleans Pelicans,125,-3
971,971,Sat Mar 11 2017,New Orleans Pelicans,125,Charlotte Hornets,122,3
2235,972,Sat Mar 11 2017,Dallas Mavericks,98,Phoenix Suns,100,-2
972,972,Sat Mar 11 2017,Phoenix Suns,100,Dallas Mavericks,98,2
973,973,Sat Mar 11 2017,New York Knicks,92,Detroit Pistons,112,-20
2236,973,Sat Mar 11 2017,Detroit Pistons,112,New York Knicks,92,20
2237,974,Sat Mar 11 2017,Los Angeles Clippers,112,Philadelphia 76ers,100,12
974,974,Sat Mar 11 2017,Philadelphia 76ers,100,Los Angeles Clippers,112,-12
2238,975,Sat Mar 11 2017,Memphis Grizzlies,90,Atlanta Hawks,107,-17
975,975,Sat Mar 11 2017,Atlanta Hawks,107,Memphis Grizzlies,90,17
2239,976,Sat Mar 11 2017,Miami Heat,104,Toronto Raptors,89,15
976,976,Sat Mar 11 2017,Toronto Raptors,89,Miami Heat,104,-15
977,977,Sat Mar 11 2017,Minnesota Timberwolves,95,Milwaukee Bucks,102,-7
2240,977,Sat Mar 11 2017,Milwaukee Bucks,102,Minnesota Timberwolves,95,7
978,978,Sat Mar 11 2017,Utah Jazz,104,Oklahoma City Thunder,112,-8
2241,978,Sat Mar 11 2017,Oklahoma City Thunder,112,Utah Jazz,104,8
2242,979,Sat Mar 11 2017,Orlando Magic,104,Cleveland Cavaliers,116,-12
979,979,Sat Mar 11 2017,Cleveland Cavaliers,116,Orlando Magic,104,12
980,980,Sat Mar 11 2017,Washington Wizards,125,Portland Trail Blazers,124,1
2243,980,Sat Mar 11 2017,Portland Trail Blazers,124,Washington Wizards,125,-1
2244,981,Sat Mar 11 2017,Sacramento Kings,92,Denver Nuggets,105,-13
981,981,Sat Mar 11 2017,Denver Nuggets,105,Sacramento Kings,92,13
2245,982,Sat Mar 11 2017,San Antonio Spurs,107,Golden State Warriors,85,22
982,982,Sat Mar 11 2017,Golden State Warriors,85,San Antonio Spurs,107,-22
2246,983,Sun Mar 12 2017,Boston Celtics,100,Chicago Bulls,80,20
983,983,Sun Mar 12 2017,Chicago Bulls,80,Boston Celtics,100,-20
2247,984,Sun Mar 12 2017,Brooklyn Nets,120,New York Knicks,112,8
984,984,Sun Mar 12 2017,New York Knicks,112,Brooklyn Nets,120,-8
985,985,Sun Mar 12 2017,Cleveland Cavaliers,112,Houston Rockets,117,-5
2248,985,Sun Mar 12 2017,Houston Rockets,117,Cleveland Cavaliers,112,5
2249,986,Sun Mar 12 2017,Indiana Pacers,102,Miami Heat,98,4
986,986,Sun Mar 12 2017,Miami Heat,98,Indiana Pacers,102,-4
2250,987,Sun Mar 12 2017,Los Angeles Lakers,116,Philadelphia 76ers,118,-2
987,987,Sun Mar 12 2017,Philadelphia 76ers,118,Los Angeles Lakers,116,2
2251,988,Sun Mar 12 2017,Phoenix Suns,101,Portland Trail Blazers,110,-9
988,988,Sun Mar 12 2017,Portland Trail Blazers,110,Phoenix Suns,101,9
2252,989,Mon Mar 13 2017,Charlotte Hornets,109,Chicago Bulls,115,-6
989,989,Mon Mar 13 2017,Chicago Bulls,115,Charlotte Hornets,109,6
2253,990,Mon Mar 13 2017,Denver Nuggets,129,Los Angeles Lakers,101,28
990,990,Mon Mar 13 2017,Los Angeles Lakers,101,Denver Nuggets,129,-28
991,991,Mon Mar 13 2017,Milwaukee Bucks,93,Memphis Grizzlies,113,-20
2254,991,Mon Mar 13 2017,Memphis Grizzlies,113,Milwaukee Bucks,93,20
992,992,Mon Mar 13 2017,Washington Wizards,104,Minnesota Timberwolves,119,-15
2255,992,Mon Mar 13 2017,Minnesota Timberwolves,119,Washington Wizards,104,15
993,993,Mon Mar 13 2017,Orlando Magic,115,Sacramento Kings,120,-5
2256,993,Mon Mar 13 2017,Sacramento Kings,120,Orlando Magic,115,5
2257,994,Mon Mar 13 2017,San Antonio Spurs,107,Atlanta Hawks,99,8
994,994,Mon Mar 13 2017,Atlanta Hawks,99,San Antonio Spurs,107,-8
995,995,Mon Mar 13 2017,Dallas Mavericks,78,Toronto Raptors,100,-22
2258,995,Mon Mar 13 2017,Toronto Raptors,100,Dallas Mavericks,78,22
2259,996,Mon Mar 13 2017,Utah Jazz,114,Los Angeles Clippers,108,6
996,996,Mon Mar 13 2017,Los Angeles Clippers,108,Utah Jazz,114,-6
997,997,Tue Mar 14 2017,Oklahoma City Thunder,122,Brooklyn Nets,104,18
2260,997,Tue Mar 14 2017,Brooklyn Nets,104,Oklahoma City Thunder,122,-18
2261,998,Tue Mar 14 2017,Cleveland Cavaliers,128,Detroit Pistons,96,32
998,998,Tue Mar 14 2017,Detroit Pistons,96,Cleveland Cavaliers,128,-32
999,999,Tue Mar 14 2017,Philadelphia 76ers,104,Golden State Warriors,106,-2
2262,999,Tue Mar 14 2017,Golden State Warriors,106,Philadelphia 76ers,104,2
1000,1000,Tue Mar 14 2017,Portland Trail Blazers,77,New Orleans Pelicans,100,-23
2263,1000,Tue Mar 14 2017,New Orleans Pelicans,100,Portland Trail Blazers,77,23
1001,1001,Tue Mar 14 2017,Indiana Pacers,81,New York Knicks,87,-6
2264,1001,Tue Mar 14 2017,New York Knicks,87,Indiana Pacers,81,6
1002,1002,Wed Mar 15 2017,Minnesota Timberwolves,104,Boston Celtics,117,-13
2265,1002,Wed Mar 15 2017,Boston Celtics,117,Minnesota Timberwolves,104,13
1003,1003,Wed Mar 15 2017,Memphis Grizzlies,98,Chicago Bulls,91,7
2266,1003,Wed Mar 15 2017,Chicago Bulls,91,Memphis Grizzlies,98,-7
2267,1004,Wed Mar 15 2017,Detroit Pistons,83,Utah Jazz,97,-14
1004,1004,Wed Mar 15 2017,Utah Jazz,97,Detroit Pistons,83,14
1005,1005,Wed Mar 15 2017,Los Angeles Lakers,100,Houston Rockets,139,-39
2268,1005,Wed Mar 15 2017,Houston Rockets,139,Los Angeles Lakers,100,39
2269,1006,Wed Mar 15 2017,Indiana Pacers,98,Charlotte Hornets,77,21
1006,1006,Wed Mar 15 2017,Charlotte Hornets,77,Indiana Pacers,98,-21
2270,1007,Wed Mar 15 2017,Los Angeles Clippers,96,Milwaukee Bucks,97,-1
1007,1007,Wed Mar 15 2017,Milwaukee Bucks,97,Los Angeles Clippers,96,1
2271,1008,Wed Mar 15 2017,Miami Heat,120,New Orleans Pelicans,112,8
1008,1008,Wed Mar 15 2017,New Orleans Pelicans,112,Miami Heat,120,-8
1009,1009,Wed Mar 15 2017,Sacramento Kings,107,Phoenix Suns,101,6
2272,1009,Wed Mar 15 2017,Phoenix Suns,101,Sacramento Kings,107,-6
1010,1010,Wed Mar 15 2017,Portland Trail Blazers,110,San Antonio Spurs,106,4
2273,1010,Wed Mar 15 2017,San Antonio Spurs,106,Portland Trail Blazers,110,-4
1011,1011,Wed Mar 15 2017,Dallas Mavericks,112,Washington Wizards,107,5
2274,1011,Wed Mar 15 2017,Washington Wizards,107,Dallas Mavericks,112,-5
2275,1012,Thu Mar 16 2017,Atlanta Hawks,91,Memphis Grizzlies,103,-12
1012,1012,Thu Mar 16 2017,Memphis Grizzlies,103,Atlanta Hawks,91,12
1013,1013,Thu Mar 16 2017,Utah Jazz,83,Cleveland Cavaliers,91,-8
2276,1013,Thu Mar 16 2017,Cleveland Cavaliers,91,Utah Jazz,83,8
1014,1014,Thu Mar 16 2017,Los Angeles Clippers,114,Denver Nuggets,129,-15
2277,1014,Thu Mar 16 2017,Denver Nuggets,129,Los Angeles Clippers,114,15
2278,1015,Thu Mar 16 2017,Golden State Warriors,122,Orlando Magic,92,30
1015,1015,Thu Mar 16 2017,Orlando Magic,92,Golden State Warriors,122,-30
1016,1016,Thu Mar 16 2017,Brooklyn Nets,121,New York Knicks,110,11
2279,1016,Thu Mar 16 2017,New York Knicks,110,Brooklyn Nets,121,-11
1017,1017,Thu Mar 16 2017,Oklahoma City Thunder,123,Toronto Raptors,102,21
2280,1017,Thu Mar 16 2017,Toronto Raptors,102,Oklahoma City Thunder,123,-21
1018,1018,Fri Mar 17 2017,Boston Celtics,98,Brooklyn Nets,95,3
2281,1018,Fri Mar 17 2017,Brooklyn Nets,95,Boston Celtics,98,-3
1019,1019,Fri Mar 17 2017,Toronto Raptors,87,Detroit Pistons,75,12
2282,1019,Fri Mar 17 2017,Detroit Pistons,75,Toronto Raptors,87,-12
2283,1020,Fri Mar 17 2017,Los Angeles Lakers,103,Milwaukee Bucks,107,-4
1020,1020,Fri Mar 17 2017,Milwaukee Bucks,107,Los Angeles Lakers,103,4
2284,1021,Fri Mar 17 2017,Miami Heat,123,Minnesota Timberwolves,105,18
1021,1021,Fri Mar 17 2017,Minnesota Timberwolves,105,Miami Heat,123,-18
2285,1022,Fri Mar 17 2017,New Orleans Pelicans,128,Houston Rockets,112,16
1022,1022,Fri Mar 17 2017,Houston Rockets,112,New Orleans Pelicans,128,-16
1023,1023,Fri Mar 17 2017,Dallas Mavericks,74,Philadelphia 76ers,116,-42
2286,1023,Fri Mar 17 2017,Philadelphia 76ers,116,Dallas Mavericks,74,42
1024,1024,Fri Mar 17 2017,Orlando Magic,109,Phoenix Suns,103,6
2287,1024,Fri Mar 17 2017,Phoenix Suns,103,Orlando Magic,109,-6
1025,1025,Fri Mar 17 2017,Chicago Bulls,107,Washington Wizards,112,-5
2288,1025,Fri Mar 17 2017,Washington Wizards,112,Chicago Bulls,107,5
1026,1026,Sat Mar 18 2017,Portland Trail Blazers,113,Atlanta Hawks,97,16
2289,1026,Sat Mar 18 2017,Atlanta Hawks,97,Portland Trail Blazers,113,-16
2290,1027,Sat Mar 18 2017,Chicago Bulls,95,Utah Jazz,86,9
1027,1027,Sat Mar 18 2017,Utah Jazz,86,Chicago Bulls,95,-9
2291,1028,Sat Mar 18 2017,Charlotte Hornets,98,Washington Wizards,93,5
1028,1028,Sat Mar 18 2017,Washington Wizards,93,Charlotte Hornets,98,-5
1029,1029,Sat Mar 18 2017,Houston Rockets,109,Denver Nuggets,105,4
2292,1029,Sat Mar 18 2017,Denver Nuggets,105,Houston Rockets,109,-4
1030,1030,Sat Mar 18 2017,Milwaukee Bucks,92,Golden State Warriors,117,-25
2293,1030,Sat Mar 18 2017,Golden State Warriors,117,Milwaukee Bucks,92,25
1031,1031,Sat Mar 18 2017,Cleveland Cavaliers,78,Los Angeles Clippers,108,-30
2294,1031,Sat Mar 18 2017,Los Angeles Clippers,108,Cleveland Cavaliers,78,30
1032,1032,Sat Mar 18 2017,San Antonio Spurs,96,Memphis Grizzlies,104,-8
2295,1032,Sat Mar 18 2017,Memphis Grizzlies,104,San Antonio Spurs,96,8
2296,1033,Sat Mar 18 2017,Oklahoma City Thunder,110,Sacramento Kings,94,16
1033,1033,Sat Mar 18 2017,Sacramento Kings,94,Oklahoma City Thunder,110,-16
1034,1034,Sun Mar 19 2017,Dallas Mavericks,111,Brooklyn Nets,104,7
2297,1034,Sun Mar 19 2017,Brooklyn Nets,104,Dallas Mavericks,111,-7
1035,1035,Sun Mar 19 2017,Phoenix Suns,95,Detroit Pistons,112,-17
2298,1035,Sun Mar 19 2017,Detroit Pistons,112,Phoenix Suns,95,17
1036,1036,Sun Mar 19 2017,Cleveland Cavaliers,125,Los Angeles Lakers,120,5
2299,1036,Sun Mar 19 2017,Los Angeles Lakers,120,Cleveland Cavaliers,125,-5
2300,1037,Sun Mar 19 2017,Miami Heat,104,Portland Trail Blazers,115,-11
1037,1037,Sun Mar 19 2017,Portland Trail Blazers,115,Miami Heat,104,11
2301,1038,Sun Mar 19 2017,New Orleans Pelicans,123,Minnesota Timberwolves,109,14
1038,1038,Sun Mar 19 2017,Minnesota Timberwolves,109,New Orleans Pelicans,123,-14
2302,1039,Sun Mar 19 2017,Philadelphia 76ers,105,Boston Celtics,99,6
1039,1039,Sun Mar 19 2017,Boston Celtics,99,Philadelphia 76ers,105,-6
1040,1040,Sun Mar 19 2017,Sacramento Kings,102,San Antonio Spurs,118,-16
2303,1040,Sun Mar 19 2017,San Antonio Spurs,118,Sacramento Kings,102,16
2304,1041,Sun Mar 19 2017,Toronto Raptors,116,Indiana Pacers,91,25
1041,1041,Sun Mar 19 2017,Indiana Pacers,91,Toronto Raptors,116,-25
1042,1042,Mon Mar 20 2017,Washington Wizards,102,Boston Celtics,110,-8
2305,1042,Mon Mar 20 2017,Boston Celtics,110,Washington Wizards,102,8
2306,1043,Mon Mar 20 2017,Charlotte Hornets,105,Atlanta Hawks,90,15
1043,1043,Mon Mar 20 2017,Atlanta Hawks,90,Charlotte Hornets,105,-15
2307,1044,Mon Mar 20 2017,Houston Rockets,125,Denver Nuggets,124,1
1044,1044,Mon Mar 20 2017,Denver Nuggets,124,Houston Rockets,125,-1
1045,1045,Mon Mar 20 2017,Utah Jazz,100,Indiana Pacers,107,-7
2308,1045,Mon Mar 20 2017,Indiana Pacers,107,Utah Jazz,100,7
2309,1046,Mon Mar 20 2017,Los Angeles Clippers,114,New York Knicks,105,9
1046,1046,Mon Mar 20 2017,New York Knicks,105,Los Angeles Clippers,114,-9
2310,1047,Mon Mar 20 2017,Oklahoma City Thunder,95,Golden State Warriors,111,-16
1047,1047,Mon Mar 20 2017,Golden State Warriors,111,Oklahoma City Thunder,95,16
2311,1048,Mon Mar 20 2017,Orlando Magic,112,Philadelphia 76ers,109,3
1048,1048,Mon Mar 20 2017,Philadelphia 76ers,109,Orlando Magic,112,-3
2312,1049,Tue Mar 21 2017,Brooklyn Nets,98,Detroit Pistons,96,2
1049,1049,Tue Mar 21 2017,Detroit Pistons,96,Brooklyn Nets,98,-2
2313,1050,Tue Mar 21 2017,Dallas Mavericks,87,Golden State Warriors,112,-25
1050,1050,Tue Mar 21 2017,Golden State Warriors,112,Dallas Mavericks,87,25
1051,1051,Tue Mar 21 2017,Los Angeles Clippers,133,Los Angeles Lakers,109,24
2314,1051,Tue Mar 21 2017,Los Angeles Lakers,109,Los Angeles Clippers,133,-24
1052,1052,Tue Mar 21 2017,Phoenix Suns,97,Miami Heat,112,-15
2315,1052,Tue Mar 21 2017,Miami Heat,112,Phoenix Suns,97,15
2316,1053,Tue Mar 21 2017,Minnesota Timberwolves,93,San Antonio Spurs,100,-7
1053,1053,Tue Mar 21 2017,San Antonio Spurs,100,Minnesota Timberwolves,93,7
1054,1054,Tue Mar 21 2017,Memphis Grizzlies,82,New Orleans Pelicans,95,-13
2317,1054,Tue Mar 21 2017,New Orleans Pelicans,95,Memphis Grizzlies,82,13
1055,1055,Tue Mar 21 2017,Milwaukee Bucks,93,Portland Trail Blazers,90,3
2318,1055,Tue Mar 21 2017,Portland Trail Blazers,90,Milwaukee Bucks,93,-3
1056,1056,Tue Mar 21 2017,Chicago Bulls,120,Toronto Raptors,122,-2
2319,1056,Tue Mar 21 2017,Toronto Raptors,122,Chicago Bulls,120,2
1057,1057,Wed Mar 22 2017,Indiana Pacers,100,Boston Celtics,109,-9
2320,1057,Wed Mar 22 2017,Boston Celtics,109,Indiana Pacers,100,9
2321,1058,Wed Mar 22 2017,Chicago Bulls,117,Detroit Pistons,95,22
1058,1058,Wed Mar 22 2017,Detroit Pistons,95,Chicago Bulls,117,-22
2322,1059,Wed Mar 22 2017,Denver Nuggets,126,Cleveland Cavaliers,113,13
1059,1059,Wed Mar 22 2017,Cleveland Cavaliers,113,Denver Nuggets,126,-13
2323,1060,Wed Mar 22 2017,Oklahoma City Thunder,122,Philadelphia 76ers,97,25
1060,1060,Wed Mar 22 2017,Philadelphia 76ers,97,Oklahoma City Thunder,122,-25
2324,1061,Wed Mar 22 2017,Orlando Magic,102,Charlotte Hornets,109,-7
1061,1061,Wed Mar 22 2017,Charlotte Hornets,109,Orlando Magic,102,7
1062,1062,Wed Mar 22 2017,Milwaukee Bucks,116,Sacramento Kings,98,18
2325,1062,Wed Mar 22 2017,Sacramento Kings,98,Milwaukee Bucks,116,-18
1063,1063,Wed Mar 22 2017,New York Knicks,101,Utah Jazz,108,-7
2326,1063,Wed Mar 22 2017,Utah Jazz,108,New York Knicks,101,7
2327,1064,Wed Mar 22 2017,Washington Wizards,104,Atlanta Hawks,100,4
1064,1064,Wed Mar 22 2017,Atlanta Hawks,100,Washington Wizards,104,-4
2328,1065,Thu Mar 23 2017,Brooklyn Nets,126,Phoenix Suns,98,28
1065,1065,Thu Mar 23 2017,Phoenix Suns,98,Brooklyn Nets,126,-28
2329,1066,Thu Mar 23 2017,Dallas Mavericks,97,Los Angeles Clippers,95,2
1066,1066,Thu Mar 23 2017,Los Angeles Clippers,95,Dallas Mavericks,97,-2
2330,1067,Thu Mar 23 2017,Miami Heat,84,Toronto Raptors,101,-17
1067,1067,Thu Mar 23 2017,Toronto Raptors,101,Miami Heat,84,17
2331,1068,Thu Mar 23 2017,Portland Trail Blazers,110,New York Knicks,95,15
1068,1068,Thu Mar 23 2017,New York Knicks,95,Portland Trail Blazers,110,-15
1069,1069,Thu Mar 23 2017,Memphis Grizzlies,90,San Antonio Spurs,97,-7
2332,1069,Thu Mar 23 2017,San Antonio Spurs,97,Memphis Grizzlies,90,7
1070,1070,Fri Mar 24 2017,Phoenix Suns,120,Boston Celtics,130,-10
2333,1070,Fri Mar 24 2017,Boston Celtics,130,Phoenix Suns,120,10
1071,1071,Fri Mar 24 2017,Philadelphia 76ers,117,Chicago Bulls,107,10
2334,1071,Fri Mar 24 2017,Chicago Bulls,107,Philadelphia 76ers,117,-10
2335,1072,Fri Mar 24 2017,Charlotte Hornets,105,Cleveland Cavaliers,112,-7
1072,1072,Fri Mar 24 2017,Cleveland Cavaliers,112,Charlotte Hornets,105,7
2336,1073,Fri Mar 24 2017,Golden State Warriors,114,Sacramento Kings,100,14
1073,1073,Fri Mar 24 2017,Sacramento Kings,100,Golden State Warriors,114,-14
2337,1074,Fri Mar 24 2017,Houston Rockets,117,New Orleans Pelicans,107,10
1074,1074,Fri Mar 24 2017,New Orleans Pelicans,107,Houston Rockets,117,-10
1075,1075,Fri Mar 24 2017,Denver Nuggets,125,Indiana Pacers,117,8
2338,1075,Fri Mar 24 2017,Indiana Pacers,117,Denver Nuggets,125,-8
1076,1076,Fri Mar 24 2017,Minnesota Timberwolves,119,Los Angeles Lakers,130,-11
2339,1076,Fri Mar 24 2017,Los Angeles Lakers,130,Minnesota Timberwolves,119,11
2340,1077,Fri Mar 24 2017,Milwaukee Bucks,100,Atlanta Hawks,97,3
1077,1077,Fri Mar 24 2017,Atlanta Hawks,97,Milwaukee Bucks,100,-3
1078,1078,Fri Mar 24 2017,Detroit Pistons,87,Orlando Magic,115,-28
2341,1078,Fri Mar 24 2017,Orlando Magic,115,Detroit Pistons,87,28
2342,1079,Fri Mar 24 2017,Washington Wizards,129,Brooklyn Nets,108,21
1079,1079,Fri Mar 24 2017,Brooklyn Nets,108,Washington Wizards,129,-21
2343,1080,Sat Mar 25 2017,Cleveland Cavaliers,115,Washington Wizards,127,-12
1080,1080,Sat Mar 25 2017,Washington Wizards,127,Cleveland Cavaliers,115,12
2344,1081,Sat Mar 25 2017,Dallas Mavericks,86,Toronto Raptors,94,-8
1081,1081,Sat Mar 25 2017,Toronto Raptors,94,Dallas Mavericks,86,8
1082,1082,Sat Mar 25 2017,Utah Jazz,95,Los Angeles Clippers,108,-13
2345,1082,Sat Mar 25 2017,Los Angeles Clippers,108,Utah Jazz,95,13
1083,1083,Sat Mar 25 2017,Minnesota Timberwolves,100,Portland Trail Blazers,112,-12
2346,1083,Sat Mar 25 2017,Portland Trail Blazers,112,Minnesota Timberwolves,100,12
1084,1084,Sat Mar 25 2017,New York Knicks,98,San Antonio Spurs,106,-8
2347,1084,Sat Mar 25 2017,San Antonio Spurs,106,New York Knicks,98,8
2348,1085,Sun Mar 26 2017,Atlanta Hawks,92,Brooklyn Nets,107,-15
1085,1085,Sun Mar 26 2017,Brooklyn Nets,107,Atlanta Hawks,92,15
1086,1086,Sun Mar 26 2017,Miami Heat,108,Boston Celtics,112,-4
2349,1086,Sun Mar 26 2017,Boston Celtics,112,Miami Heat,108,4
1087,1087,Sun Mar 26 2017,Phoenix Suns,106,Charlotte Hornets,120,-14
2350,1087,Sun Mar 26 2017,Charlotte Hornets,120,Phoenix Suns,106,14
2351,1088,Sun Mar 26 2017,Denver Nuggets,90,New Orleans Pelicans,115,-25
1088,1088,Sun Mar 26 2017,New Orleans Pelicans,115,Denver Nuggets,90,25
2352,1089,Sun Mar 26 2017,Golden State Warriors,106,Memphis Grizzlies,94,12
1089,1089,Sun Mar 26 2017,Memphis Grizzlies,94,Golden State Warriors,106,-12
1090,1090,Sun Mar 26 2017,Oklahoma City Thunder,125,Houston Rockets,137,-12
2353,1090,Sun Mar 26 2017,Houston Rockets,137,Oklahoma City Thunder,125,12
2354,1091,Sun Mar 26 2017,Indiana Pacers,107,Philadelphia 76ers,94,13
1091,1091,Sun Mar 26 2017,Philadelphia 76ers,94,Indiana Pacers,107,-13
2355,1092,Sun Mar 26 2017,Los Angeles Clippers,97,Sacramento Kings,98,-1
1092,1092,Sun Mar 26 2017,Sacramento Kings,98,Los Angeles Clippers,97,1
1093,1093,Sun Mar 26 2017,Portland Trail Blazers,97,Los Angeles Lakers,81,16
2356,1093,Sun Mar 26 2017,Los Angeles Lakers,81,Portland Trail Blazers,97,-16
2357,1094,Sun Mar 26 2017,Milwaukee Bucks,94,Chicago Bulls,109,-15
1094,1094,Sun Mar 26 2017,Chicago Bulls,109,Milwaukee Bucks,94,15
1095,1095,Mon Mar 27 2017,Oklahoma City Thunder,92,Dallas Mavericks,91,1
2358,1095,Mon Mar 27 2017,Dallas Mavericks,91,Oklahoma City Thunder,92,-1
2359,1096,Mon Mar 27 2017,New York Knicks,109,Detroit Pistons,95,14
1096,1096,Mon Mar 27 2017,Detroit Pistons,95,New York Knicks,109,-14
1097,1097,Mon Mar 27 2017,Memphis Grizzlies,90,Sacramento Kings,91,-1
2360,1097,Mon Mar 27 2017,Sacramento Kings,91,Memphis Grizzlies,90,1
1098,1098,Mon Mar 27 2017,Cleveland Cavaliers,74,San Antonio Spurs,103,-29
2361,1098,Mon Mar 27 2017,San Antonio Spurs,103,Cleveland Cavaliers,74,29
1099,1099,Mon Mar 27 2017,Orlando Magic,112,Toronto Raptors,131,-19
2362,1099,Mon Mar 27 2017,Toronto Raptors,131,Orlando Magic,112,19
2363,1100,Mon Mar 27 2017,Utah Jazz,108,New Orleans Pelicans,100,8
1100,1100,Mon Mar 27 2017,New Orleans Pelicans,100,Utah Jazz,108,-8
1101,1101,Tue Mar 28 2017,Phoenix Suns,91,Atlanta Hawks,95,-4
2364,1101,Tue Mar 28 2017,Atlanta Hawks,95,Phoenix Suns,91,4
2365,1102,Tue Mar 28 2017,Brooklyn Nets,101,Philadelphia 76ers,106,-5
1102,1102,Tue Mar 28 2017,Philadelphia 76ers,106,Brooklyn Nets,101,5
2366,1103,Tue Mar 28 2017,Charlotte Hornets,108,Milwaukee Bucks,118,-10
1103,1103,Tue Mar 28 2017,Milwaukee Bucks,118,Charlotte Hornets,108,10
2367,1104,Tue Mar 28 2017,Detroit Pistons,96,Miami Heat,97,-1
1104,1104,Tue Mar 28 2017,Miami Heat,97,Detroit Pistons,96,1
1105,1105,Tue Mar 28 2017,Golden State Warriors,113,Houston Rockets,106,7
2368,1105,Tue Mar 28 2017,Houston Rockets,106,Golden State Warriors,113,-7
1106,1106,Tue Mar 28 2017,Minnesota Timberwolves,115,Indiana Pacers,114,1
2369,1106,Tue Mar 28 2017,Indiana Pacers,114,Minnesota Timberwolves,115,-1
2370,1107,Tue Mar 28 2017,Los Angeles Lakers,108,Washington Wizards,119,-11
1107,1107,Tue Mar 28 2017,Washington Wizards,119,Los Angeles Lakers,108,11
1108,1108,Tue Mar 28 2017,Denver Nuggets,113,Portland Trail Blazers,122,-9
2371,1108,Tue Mar 28 2017,Portland Trail Blazers,122,Denver Nuggets,113,9
2372,1109,Wed Mar 29 2017,Boston Celtics,100,Milwaukee Bucks,103,-3
1109,1109,Wed Mar 29 2017,Milwaukee Bucks,103,Boston Celtics,100,3
2373,1110,Wed Mar 29 2017,Los Angeles Clippers,133,Washington Wizards,124,9
1110,1110,Wed Mar 29 2017,Washington Wizards,124,Los Angeles Clippers,133,-9
2374,1111,Wed Mar 29 2017,Memphis Grizzlies,110,Indiana Pacers,97,13
1111,1111,Wed Mar 29 2017,Indiana Pacers,97,Memphis Grizzlies,110,-13
2375,1112,Wed Mar 29 2017,New Orleans Pelicans,121,Dallas Mavericks,118,3
1112,1112,Wed Mar 29 2017,Dallas Mavericks,118,New Orleans Pelicans,121,-3
1113,1113,Wed Mar 29 2017,Miami Heat,105,New York Knicks,88,17
2376,1113,Wed Mar 29 2017,New York Knicks,88,Miami Heat,105,-17
2377,1114,Wed Mar 29 2017,Orlando Magic,106,Oklahoma City Thunder,114,-8
1114,1114,Wed Mar 29 2017,Oklahoma City Thunder,114,Orlando Magic,106,8
2378,1115,Wed Mar 29 2017,Philadelphia 76ers,92,Atlanta Hawks,99,-7
1115,1115,Wed Mar 29 2017,Atlanta Hawks,99,Philadelphia 76ers,92,7
2379,1116,Wed Mar 29 2017,Sacramento Kings,82,Utah Jazz,112,-30
1116,1116,Wed Mar 29 2017,Utah Jazz,112,Sacramento Kings,82,30
2380,1117,Wed Mar 29 2017,San Antonio Spurs,98,Golden State Warriors,110,-12
1117,1117,Wed Mar 29 2017,Golden State Warriors,110,San Antonio Spurs,98,12
2381,1118,Wed Mar 29 2017,Toronto Raptors,106,Charlotte Hornets,110,-4
1118,1118,Wed Mar 29 2017,Charlotte Hornets,110,Toronto Raptors,106,4
1119,1119,Thu Mar 30 2017,Cleveland Cavaliers,93,Chicago Bulls,99,-6
2382,1119,Thu Mar 30 2017,Chicago Bulls,99,Cleveland Cavaliers,93,6
1120,1120,Thu Mar 30 2017,Brooklyn Nets,89,Detroit Pistons,90,-1
2383,1120,Thu Mar 30 2017,Detroit Pistons,90,Brooklyn Nets,89,1
1121,1121,Thu Mar 30 2017,Los Angeles Lakers,104,Minnesota Timberwolves,119,-15
2384,1121,Thu Mar 30 2017,Minnesota Timberwolves,119,Los Angeles Lakers,104,15
2385,1122,Thu Mar 30 2017,Phoenix Suns,118,Los Angeles Clippers,124,-6
1122,1122,Thu Mar 30 2017,Los Angeles Clippers,124,Phoenix Suns,118,6
1123,1123,Thu Mar 30 2017,Houston Rockets,107,Portland Trail Blazers,117,-10
2386,1123,Thu Mar 30 2017,Portland Trail Blazers,117,Houston Rockets,107,10
2387,1124,Fri Mar 31 2017,Boston Celtics,117,Orlando Magic,116,1
1124,1124,Fri Mar 31 2017,Orlando Magic,116,Boston Celtics,117,-1
1125,1125,Fri Mar 31 2017,Denver Nuggets,114,Charlotte Hornets,122,-8
2388,1125,Fri Mar 31 2017,Charlotte Hornets,122,Denver Nuggets,114,8
2389,1126,Fri Mar 31 2017,Cleveland Cavaliers,122,Philadelphia 76ers,105,17
1126,1126,Fri Mar 31 2017,Philadelphia 76ers,105,Cleveland Cavaliers,122,-17
1127,1127,Fri Mar 31 2017,Houston Rockets,98,Golden State Warriors,107,-9
2390,1127,Fri Mar 31 2017,Golden State Warriors,107,Houston Rockets,98,9
1128,1128,Fri Mar 31 2017,Dallas Mavericks,90,Memphis Grizzlies,99,-9
2391,1128,Fri Mar 31 2017,Memphis Grizzlies,99,Dallas Mavericks,90,9
1129,1129,Fri Mar 31 2017,New York Knicks,98,Miami Heat,94,4
2392,1129,Fri Mar 31 2017,Miami Heat,94,New York Knicks,98,-4
1130,1130,Fri Mar 31 2017,Detroit Pistons,105,Milwaukee Bucks,108,-3
2393,1130,Fri Mar 31 2017,Milwaukee Bucks,108,Detroit Pistons,105,3
1131,1131,Fri Mar 31 2017,Sacramento Kings,89,New Orleans Pelicans,117,-28
2394,1131,Fri Mar 31 2017,New Orleans Pelicans,117,Sacramento Kings,89,28
2395,1132,Fri Mar 31 2017,Oklahoma City Thunder,95,San Antonio Spurs,100,-5
1132,1132,Fri Mar 31 2017,San Antonio Spurs,100,Oklahoma City Thunder,95,5
1133,1133,Fri Mar 31 2017,Indiana Pacers,100,Toronto Raptors,111,-11
2396,1133,Fri Mar 31 2017,Toronto Raptors,111,Indiana Pacers,100,11
2397,1134,Fri Mar 31 2017,Utah Jazz,95,Washington Wizards,88,7
1134,1134,Fri Mar 31 2017,Washington Wizards,88,Utah Jazz,95,-7
2398,1135,Sat Apr 1 2017,Brooklyn Nets,121,Orlando Magic,111,10
1135,1135,Sat Apr 1 2017,Orlando Magic,111,Brooklyn Nets,121,-10
2399,1136,Sat Apr 1 2017,Chicago Bulls,106,Atlanta Hawks,104,2
1136,1136,Sat Apr 1 2017,Atlanta Hawks,104,Chicago Bulls,106,-2
1137,1137,Sat Apr 1 2017,Los Angeles Lakers,104,Los Angeles Clippers,115,-11
2400,1137,Sat Apr 1 2017,Los Angeles Clippers,115,Los Angeles Lakers,104,11
1138,1138,Sat Apr 1 2017,Sacramento Kings,123,Minnesota Timberwolves,117,6
2401,1138,Sat Apr 1 2017,Minnesota Timberwolves,117,Sacramento Kings,123,-6
1139,1139,Sat Apr 1 2017,Phoenix Suns,117,Portland Trail Blazers,130,-13
2402,1139,Sat Apr 1 2017,Portland Trail Blazers,130,Phoenix Suns,117,13
2403,1140,Sun Apr 2 2017,Brooklyn Nets,91,Atlanta Hawks,82,9
1140,1140,Sun Apr 2 2017,Atlanta Hawks,82,Brooklyn Nets,91,-9
1141,1141,Sun Apr 2 2017,Indiana Pacers,130,Cleveland Cavaliers,135,-5
2404,1141,Sun Apr 2 2017,Cleveland Cavaliers,135,Indiana Pacers,130,5
1142,1142,Sun Apr 2 2017,Washington Wizards,115,Golden State Warriors,139,-24
2405,1142,Sun Apr 2 2017,Golden State Warriors,139,Washington Wizards,115,24
2406,1143,Sun Apr 2 2017,Los Angeles Lakers,108,Memphis Grizzlies,103,5
1143,1143,Sun Apr 2 2017,Memphis Grizzlies,103,Los Angeles Lakers,108,-5
1144,1144,Sun Apr 2 2017,Denver Nuggets,116,Miami Heat,113,3
2407,1144,Sun Apr 2 2017,Miami Heat,113,Denver Nuggets,116,-3
1145,1145,Sun Apr 2 2017,Dallas Mavericks,109,Milwaukee Bucks,105,4
2408,1145,Sun Apr 2 2017,Milwaukee Bucks,105,Dallas Mavericks,109,-4
1146,1146,Sun Apr 2 2017,Chicago Bulls,117,New Orleans Pelicans,110,7
2409,1146,Sun Apr 2 2017,New Orleans Pelicans,110,Chicago Bulls,117,-7
1147,1147,Sun Apr 2 2017,Boston Celtics,110,New York Knicks,94,16
2410,1147,Sun Apr 2 2017,New York Knicks,94,Boston Celtics,110,-16
2411,1148,Sun Apr 2 2017,Oklahoma City Thunder,101,Charlotte Hornets,113,-12
1148,1148,Sun Apr 2 2017,Charlotte Hornets,113,Oklahoma City Thunder,101,12
2412,1149,Sun Apr 2 2017,Phoenix Suns,116,Houston Rockets,123,-7
1149,1149,Sun Apr 2 2017,Houston Rockets,123,Phoenix Suns,116,7
2413,1150,Sun Apr 2 2017,San Antonio Spurs,109,Utah Jazz,103,6
1150,1150,Sun Apr 2 2017,Utah Jazz,103,San Antonio Spurs,109,-6
1151,1151,Sun Apr 2 2017,Philadelphia 76ers,105,Toronto Raptors,113,-8
2414,1151,Sun Apr 2 2017,Toronto Raptors,113,Philadelphia 76ers,105,8
1152,1152,Mon Apr 3 2017,Portland Trail Blazers,109,Minnesota Timberwolves,110,-1
2415,1152,Mon Apr 3 2017,Minnesota Timberwolves,110,Portland Trail Blazers,109,1
1153,1153,Tue Apr 4 2017,Orlando Magic,102,Cleveland Cavaliers,122,-20
2416,1153,Tue Apr 4 2017,Cleveland Cavaliers,122,Orlando Magic,102,20
1154,1154,Tue Apr 4 2017,Minnesota Timberwolves,107,Golden State Warriors,121,-14
2417,1154,Tue Apr 4 2017,Golden State Warriors,121,Minnesota Timberwolves,107,14
2418,1155,Tue Apr 4 2017,Indiana Pacers,108,Toronto Raptors,90,18
1155,1155,Tue Apr 4 2017,Toronto Raptors,90,Indiana Pacers,108,-18
2419,1156,Tue Apr 4 2017,New Orleans Pelicans,131,Denver Nuggets,134,-3
1156,1156,Tue Apr 4 2017,Denver Nuggets,134,New Orleans Pelicans,131,3
2420,1157,Tue Apr 4 2017,New York Knicks,100,Chicago Bulls,91,9
1157,1157,Tue Apr 4 2017,Chicago Bulls,91,New York Knicks,100,-9
1158,1158,Tue Apr 4 2017,Milwaukee Bucks,79,Oklahoma City Thunder,110,-31
2421,1158,Tue Apr 4 2017,Oklahoma City Thunder,110,Milwaukee Bucks,79,31
1159,1159,Tue Apr 4 2017,Brooklyn Nets,141,Philadelphia 76ers,118,23
2422,1159,Tue Apr 4 2017,Philadelphia 76ers,118,Brooklyn Nets,141,-23
1160,1160,Tue Apr 4 2017,Dallas Mavericks,87,Sacramento Kings,98,-11
2423,1160,Tue Apr 4 2017,Sacramento Kings,98,Dallas Mavericks,87,11
2424,1161,Tue Apr 4 2017,San Antonio Spurs,95,Memphis Grizzlies,89,6
1161,1161,Tue Apr 4 2017,Memphis Grizzlies,89,San Antonio Spurs,95,-6
2425,1162,Tue Apr 4 2017,Utah Jazz,106,Portland Trail Blazers,87,19
1162,1162,Tue Apr 4 2017,Portland Trail Blazers,87,Utah Jazz,106,-19
2426,1163,Tue Apr 4 2017,Washington Wizards,118,Charlotte Hornets,111,7
1163,1163,Tue Apr 4 2017,Charlotte Hornets,111,Washington Wizards,118,-7
2427,1164,Wed Apr 5 2017,Boston Celtics,91,Cleveland Cavaliers,114,-23
1164,1164,Wed Apr 5 2017,Cleveland Cavaliers,114,Boston Celtics,91,23
2428,1165,Wed Apr 5 2017,Charlotte Hornets,99,Miami Heat,112,-13
1165,1165,Wed Apr 5 2017,Miami Heat,112,Charlotte Hornets,99,13
1166,1166,Wed Apr 5 2017,Toronto Raptors,105,Detroit Pistons,102,3
2429,1166,Wed Apr 5 2017,Detroit Pistons,102,Toronto Raptors,105,-3
1167,1167,Wed Apr 5 2017,Denver Nuggets,104,Houston Rockets,110,-6
2430,1167,Wed Apr 5 2017,Houston Rockets,110,Denver Nuggets,104,6
2431,1168,Wed Apr 5 2017,Los Angeles Clippers,112,Dallas Mavericks,101,11
1168,1168,Wed Apr 5 2017,Dallas Mavericks,101,Los Angeles Clippers,112,-11
1169,1169,Wed Apr 5 2017,Oklahoma City Thunder,103,Memphis Grizzlies,100,3
2432,1169,Wed Apr 5 2017,Memphis Grizzlies,100,Oklahoma City Thunder,103,-3
2433,1170,Wed Apr 5 2017,Phoenix Suns,111,Golden State Warriors,120,-9
1170,1170,Wed Apr 5 2017,Golden State Warriors,120,Phoenix Suns,111,9
2434,1171,Wed Apr 5 2017,San Antonio Spurs,95,Los Angeles Lakers,102,-7
1171,1171,Wed Apr 5 2017,Los Angeles Lakers,102,San Antonio Spurs,95,7
2435,1172,Thu Apr 6 2017,Atlanta Hawks,123,Boston Celtics,116,7
1172,1172,Thu Apr 6 2017,Boston Celtics,116,Atlanta Hawks,123,-7
1173,1173,Thu Apr 6 2017,Milwaukee Bucks,89,Indiana Pacers,104,-15
2436,1173,Thu Apr 6 2017,Indiana Pacers,104,Milwaukee Bucks,89,15
2437,1174,Thu Apr 6 2017,New York Knicks,103,Washington Wizards,106,-3
1174,1174,Thu Apr 6 2017,Washington Wizards,106,New York Knicks,103,3
1175,1175,Thu Apr 6 2017,Brooklyn Nets,107,Orlando Magic,115,-8
2438,1175,Thu Apr 6 2017,Orlando Magic,115,Brooklyn Nets,107,8
1176,1176,Thu Apr 6 2017,Chicago Bulls,102,Philadelphia 76ers,90,12
2439,1176,Thu Apr 6 2017,Philadelphia 76ers,90,Chicago Bulls,102,-12
2440,1177,Thu Apr 6 2017,Portland Trail Blazers,105,Minnesota Timberwolves,98,7
1177,1177,Thu Apr 6 2017,Minnesota Timberwolves,98,Portland Trail Blazers,105,-7
2441,1178,Fri Apr 7 2017,Cleveland Cavaliers,100,Atlanta Hawks,114,-14
1178,1178,Fri Apr 7 2017,Atlanta Hawks,114,Cleveland Cavaliers,100,14
1179,1179,Fri Apr 7 2017,San Antonio Spurs,102,Dallas Mavericks,89,13
2442,1179,Fri Apr 7 2017,Dallas Mavericks,89,San Antonio Spurs,102,-13
2443,1180,Fri Apr 7 2017,Denver Nuggets,122,New Orleans Pelicans,106,16
1180,1180,Fri Apr 7 2017,New Orleans Pelicans,106,Denver Nuggets,122,-16
1181,1181,Fri Apr 7 2017,Detroit Pistons,114,Houston Rockets,109,5
2444,1181,Fri Apr 7 2017,Houston Rockets,109,Detroit Pistons,114,-5
1182,1182,Fri Apr 7 2017,Sacramento Kings,94,Los Angeles Lakers,98,-4
2445,1182,Fri Apr 7 2017,Los Angeles Lakers,98,Sacramento Kings,94,4
1183,1183,Fri Apr 7 2017,New York Knicks,88,Memphis Grizzlies,101,-13
2446,1183,Fri Apr 7 2017,Memphis Grizzlies,101,New York Knicks,88,13
1184,1184,Fri Apr 7 2017,Oklahoma City Thunder,99,Phoenix Suns,120,-21
2447,1184,Fri Apr 7 2017,Phoenix Suns,120,Oklahoma City Thunder,99,21
1185,1185,Fri Apr 7 2017,Miami Heat,94,Toronto Raptors,96,-2
2448,1185,Fri Apr 7 2017,Toronto Raptors,96,Miami Heat,94,2
1186,1186,Fri Apr 7 2017,Minnesota Timberwolves,113,Utah Jazz,120,-7
2449,1186,Fri Apr 7 2017,Utah Jazz,120,Minnesota Timberwolves,113,7
2450,1187,Sat Apr 8 2017,Brooklyn Nets,107,Chicago Bulls,106,1
1187,1187,Sat Apr 8 2017,Chicago Bulls,106,Brooklyn Nets,107,-1
2451,1188,Sat Apr 8 2017,Charlotte Hornets,114,Boston Celtics,121,-7
1188,1188,Sat Apr 8 2017,Boston Celtics,121,Charlotte Hornets,114,7
1189,1189,Sat Apr 8 2017,New Orleans Pelicans,101,Golden State Warriors,123,-22
2452,1189,Sat Apr 8 2017,Golden State Warriors,123,New Orleans Pelicans,101,22
2453,1190,Sat Apr 8 2017,Orlando Magic,112,Indiana Pacers,127,-15
1190,1190,Sat Apr 8 2017,Indiana Pacers,127,Orlando Magic,112,15
1191,1191,Sat Apr 8 2017,Milwaukee Bucks,90,Philadelphia 76ers,82,8
2454,1191,Sat Apr 8 2017,Philadelphia 76ers,82,Milwaukee Bucks,90,-8
1192,1192,Sat Apr 8 2017,Utah Jazz,86,Portland Trail Blazers,101,-15
2455,1192,Sat Apr 8 2017,Portland Trail Blazers,101,Utah Jazz,86,15
1193,1193,Sat Apr 8 2017,Los Angeles Clippers,98,San Antonio Spurs,87,11
2456,1193,Sat Apr 8 2017,San Antonio Spurs,87,Los Angeles Clippers,98,-11
1194,1194,Sat Apr 8 2017,Miami Heat,106,Washington Wizards,103,3
2457,1194,Sat Apr 8 2017,Washington Wizards,103,Miami Heat,106,-3
1195,1195,Sun Apr 9 2017,Cleveland Cavaliers,125,Atlanta Hawks,126,-1
2458,1195,Sun Apr 9 2017,Atlanta Hawks,126,Cleveland Cavaliers,125,1
2459,1196,Sun Apr 9 2017,Denver Nuggets,105,Oklahoma City Thunder,106,-1
1196,1196,Sun Apr 9 2017,Oklahoma City Thunder,106,Denver Nuggets,105,1
1197,1197,Sun Apr 9 2017,Minnesota Timberwolves,109,Los Angeles Lakers,110,-1
2460,1197,Sun Apr 9 2017,Los Angeles Lakers,110,Minnesota Timberwolves,109,1
2461,1198,Sun Apr 9 2017,Memphis Grizzlies,90,Detroit Pistons,103,-13
1198,1198,Sun Apr 9 2017,Detroit Pistons,103,Memphis Grizzlies,90,13
2462,1199,Sun Apr 9 2017,New York Knicks,97,Toronto Raptors,110,-13
1199,1199,Sun Apr 9 2017,Toronto Raptors,110,New York Knicks,97,13
2463,1200,Sun Apr 9 2017,Phoenix Suns,124,Dallas Mavericks,111,13
1200,1200,Sun Apr 9 2017,Dallas Mavericks,111,Phoenix Suns,124,-13
1201,1201,Sun Apr 9 2017,Houston Rockets,135,Sacramento Kings,128,7
2464,1201,Sun Apr 9 2017,Sacramento Kings,128,Houston Rockets,135,-7
1202,1202,Mon Apr 10 2017,Brooklyn Nets,105,Boston Celtics,114,-9
2465,1202,Mon Apr 10 2017,Boston Celtics,114,Brooklyn Nets,105,9
1203,1203,Mon Apr 10 2017,Orlando Magic,75,Chicago Bulls,122,-47
2466,1203,Mon Apr 10 2017,Chicago Bulls,122,Orlando Magic,75,47
2467,1204,Mon Apr 10 2017,Detroit Pistons,101,Washington Wizards,105,-4
1204,1204,Mon Apr 10 2017,Washington Wizards,105,Detroit Pistons,101,4
2468,1205,Mon Apr 10 2017,Golden State Warriors,99,Utah Jazz,105,-6
1205,1205,Mon Apr 10 2017,Utah Jazz,105,Golden State Warriors,99,6
1206,1206,Mon Apr 10 2017,Houston Rockets,96,Los Angeles Clippers,125,-29
2469,1206,Mon Apr 10 2017,Los Angeles Clippers,125,Houston Rockets,96,29
2470,1207,Mon Apr 10 2017,Miami Heat,124,Cleveland Cavaliers,121,3
1207,1207,Mon Apr 10 2017,Cleveland Cavaliers,121,Miami Heat,124,-3
1208,1208,Mon Apr 10 2017,Charlotte Hornets,79,Milwaukee Bucks,89,-10
2471,1208,Mon Apr 10 2017,Milwaukee Bucks,89,Charlotte Hornets,79,10
1209,1209,Mon Apr 10 2017,Indiana Pacers,120,Philadelphia 76ers,111,9
2472,1209,Mon Apr 10 2017,Philadelphia 76ers,111,Indiana Pacers,120,-9
1210,1210,Mon Apr 10 2017,San Antonio Spurs,98,Portland Trail Blazers,99,-1
2473,1210,Mon Apr 10 2017,Portland Trail Blazers,99,San Antonio Spurs,98,1
1211,1211,Tue Apr 11 2017,Charlotte Hornets,76,Atlanta Hawks,103,-27
2474,1211,Tue Apr 11 2017,Atlanta Hawks,103,Charlotte Hornets,76,27
2475,1212,Tue Apr 11 2017,Dallas Mavericks,91,Denver Nuggets,109,-18
1212,1212,Tue Apr 11 2017,Denver Nuggets,109,Dallas Mavericks,91,18
2476,1213,Tue Apr 11 2017,Los Angeles Lakers,108,New Orleans Pelicans,96,12
1213,1213,Tue Apr 11 2017,New Orleans Pelicans,96,Los Angeles Lakers,108,-12
1214,1214,Tue Apr 11 2017,Oklahoma City Thunder,100,Minnesota Timberwolves,98,2
2477,1214,Tue Apr 11 2017,Minnesota Timberwolves,98,Oklahoma City Thunder,100,-2
2478,1215,Tue Apr 11 2017,Sacramento Kings,129,Phoenix Suns,104,25
1215,1215,Tue Apr 11 2017,Phoenix Suns,104,Sacramento Kings,129,-25
1216,1216,Wed Apr 12 2017,Milwaukee Bucks,94,Boston Celtics,112,-18
2479,1216,Wed Apr 12 2017,Boston Celtics,112,Milwaukee Bucks,94,18
1217,1217,Wed Apr 12 2017,Brooklyn Nets,73,Chicago Bulls,112,-39
2480,1217,Wed Apr 12 2017,Chicago Bulls,112,Brooklyn Nets,73,39
1218,1218,Wed Apr 12 2017,Toronto Raptors,98,Cleveland Cavaliers,83,15
2481,1218,Wed Apr 12 2017,Cleveland Cavaliers,83,Toronto Raptors,98,-15
2482,1219,Wed Apr 12 2017,Golden State Warriors,109,Los Angeles Lakers,94,15
1219,1219,Wed Apr 12 2017,Los Angeles Lakers,94,Golden State Warriors,109,-15
2483,1220,Wed Apr 12 2017,Houston Rockets,123,Minnesota Timberwolves,118,5
1220,1220,Wed Apr 12 2017,Minnesota Timberwolves,118,Houston Rockets,123,-5
2484,1221,Wed Apr 12 2017,Indiana Pacers,104,Atlanta Hawks,86,18
1221,1221,Wed Apr 12 2017,Atlanta Hawks,86,Indiana Pacers,104,-18
1222,1222,Wed Apr 12 2017,Sacramento Kings,95,Los Angeles Clippers,115,-20
2485,1222,Wed Apr 12 2017,Los Angeles Clippers,115,Sacramento Kings,95,20
1223,1223,Wed Apr 12 2017,Dallas Mavericks,100,Memphis Grizzlies,93,7
2486,1223,Wed Apr 12 2017,Memphis Grizzlies,93,Dallas Mavericks,100,-7
2487,1224,Wed Apr 12 2017,Miami Heat,110,Washington Wizards,102,8
1224,1224,Wed Apr 12 2017,Washington Wizards,102,Miami Heat,110,-8
1225,1225,Wed Apr 12 2017,Philadelphia 76ers,113,New York Knicks,114,-1
2488,1225,Wed Apr 12 2017,New York Knicks,114,Philadelphia 76ers,113,1
1226,1226,Wed Apr 12 2017,Denver Nuggets,111,Oklahoma City Thunder,105,6
2489,1226,Wed Apr 12 2017,Oklahoma City Thunder,105,Denver Nuggets,111,-6
1227,1227,Wed Apr 12 2017,Detroit Pistons,109,Orlando Magic,113,-4
2490,1227,Wed Apr 12 2017,Orlando Magic,113,Detroit Pistons,109,4
2491,1228,Wed Apr 12 2017,Portland Trail Blazers,100,New Orleans Pelicans,103,-3
1228,1228,Wed Apr 12 2017,New Orleans Pelicans,103,Portland Trail Blazers,100,3
1229,1229,Wed Apr 12 2017,San Antonio Spurs,97,Utah Jazz,101,-4
2492,1229,Wed Apr 12 2017,Utah Jazz,101,San Antonio Spurs,97,4
2493,1230,Sat Apr 15 2017,Cleveland Cavaliers,109,Indiana Pacers,108,1
1230,1230,Sat Apr 15 2017,Indiana Pacers,108,Cleveland Cavaliers,109,-1
2494,1231,Sat Apr 15 2017,Los Angeles Clippers,95,Utah Jazz,97,-2
1231,1231,Sat Apr 15 2017,Utah Jazz,97,Los Angeles Clippers,95,2
2495,1232,Sat Apr 15 2017,San Antonio Spurs,111,Memphis Grizzlies,82,29
1232,1232,Sat Apr 15 2017,Memphis Grizzlies,82,San Antonio Spurs,111,-29
1233,1233,Sat Apr 15 2017,Milwaukee Bucks,97,Toronto Raptors,83,14
2496,1233,Sat Apr 15 2017,Toronto Raptors,83,Milwaukee Bucks,97,-14
1234,1234,Sun Apr 16 2017,Chicago Bulls,106,Boston Celtics,102,4
2497,1234,Sun Apr 16 2017,Boston Celtics,102,Chicago Bulls,106,-4
1235,1235,Sun Apr 16 2017,Portland Trail Blazers,109,Golden State Warriors,121,-12
2498,1235,Sun Apr 16 2017,Golden State Warriors,121,Portland Trail Blazers,109,12
2499,1236,Sun Apr 16 2017,Houston Rockets,118,Oklahoma City Thunder,87,31
1236,1236,Sun Apr 16 2017,Oklahoma City Thunder,87,Houston Rockets,118,-31
1237,1237,Sun Apr 16 2017,Atlanta Hawks,107,Washington Wizards,114,-7
2500,1237,Sun Apr 16 2017,Washington Wizards,114,Atlanta Hawks,107,7
2501,1238,Mon Apr 17 2017,Cleveland Cavaliers,117,Indiana Pacers,111,6
1238,1238,Mon Apr 17 2017,Indiana Pacers,111,Cleveland Cavaliers,117,-6
1239,1239,Mon Apr 17 2017,Memphis Grizzlies,82,San Antonio Spurs,96,-14
2502,1239,Mon Apr 17 2017,San Antonio Spurs,96,Memphis Grizzlies,82,14
2503,1240,Tue Apr 18 2017,Boston Celtics,97,Chicago Bulls,111,-14
1240,1240,Tue Apr 18 2017,Chicago Bulls,111,Boston Celtics,97,14
1241,1241,Tue Apr 18 2017,Utah Jazz,91,Los Angeles Clippers,99,-8
2504,1241,Tue Apr 18 2017,Los Angeles Clippers,99,Utah Jazz,91,8
2505,1242,Tue Apr 18 2017,Toronto Raptors,106,Milwaukee Bucks,100,6
1242,1242,Tue Apr 18 2017,Milwaukee Bucks,100,Toronto Raptors,106,-6
2506,1243,Wed Apr 19 2017,Golden State Warriors,110,Portland Trail Blazers,81,29
1243,1243,Wed Apr 19 2017,Portland Trail Blazers,81,Golden State Warriors,110,-29
2507,1244,Wed Apr 19 2017,Houston Rockets,115,Oklahoma City Thunder,111,4
1244,1244,Wed Apr 19 2017,Oklahoma City Thunder,111,Houston Rockets,115,-4
1245,1245,Wed Apr 19 2017,Atlanta Hawks,101,Washington Wizards,109,-8
2508,1245,Wed Apr 19 2017,Washington Wizards,109,Atlanta Hawks,101,8
2509,1246,Thu Apr 20 2017,Indiana Pacers,114,Cleveland Cavaliers,119,-5
1246,1246,Thu Apr 20 2017,Cleveland Cavaliers,119,Indiana Pacers,114,5
2510,1247,Thu Apr 20 2017,Memphis Grizzlies,105,San Antonio Spurs,94,11
1247,1247,Thu Apr 20 2017,San Antonio Spurs,94,Memphis Grizzlies,105,-11
2511,1248,Thu Apr 20 2017,Milwaukee Bucks,104,Toronto Raptors,77,27
1248,1248,Thu Apr 20 2017,Toronto Raptors,77,Milwaukee Bucks,104,-27
1249,1249,Fri Apr 21 2017,Boston Celtics,104,Chicago Bulls,87,17
2512,1249,Fri Apr 21 2017,Chicago Bulls,87,Boston Celtics,104,-17
2513,1250,Fri Apr 21 2017,Oklahoma City Thunder,115,Houston Rockets,113,2
1250,1250,Fri Apr 21 2017,Houston Rockets,113,Oklahoma City Thunder,115,-2
2514,1251,Fri Apr 21 2017,Utah Jazz,106,Los Angeles Clippers,111,-5
1251,1251,Fri Apr 21 2017,Los Angeles Clippers,111,Utah Jazz,106,5
2515,1252,Sat Apr 22 2017,Atlanta Hawks,116,Washington Wizards,98,18
1252,1252,Sat Apr 22 2017,Washington Wizards,98,Atlanta Hawks,116,-18
2516,1253,Sat Apr 22 2017,Memphis Grizzlies,110,San Antonio Spurs,108,2
1253,1253,Sat Apr 22 2017,San Antonio Spurs,108,Memphis Grizzlies,110,-2
2517,1254,Sat Apr 22 2017,Milwaukee Bucks,76,Toronto Raptors,87,-11
1254,1254,Sat Apr 22 2017,Toronto Raptors,87,Milwaukee Bucks,76,11
2518,1255,Sat Apr 22 2017,Portland Trail Blazers,113,Golden State Warriors,119,-6
1255,1255,Sat Apr 22 2017,Golden State Warriors,119,Portland Trail Blazers,113,6
2519,1256,Sun Apr 23 2017,Chicago Bulls,95,Boston Celtics,104,-9
1256,1256,Sun Apr 23 2017,Boston Celtics,104,Chicago Bulls,95,9
1257,1257,Sun Apr 23 2017,Cleveland Cavaliers,106,Indiana Pacers,102,4
2520,1257,Sun Apr 23 2017,Indiana Pacers,102,Cleveland Cavaliers,106,-4
2521,1258,Sun Apr 23 2017,Oklahoma City Thunder,109,Houston Rockets,113,-4
1258,1258,Sun Apr 23 2017,Houston Rockets,113,Oklahoma City Thunder,109,4
2522,1259,Sun Apr 23 2017,Utah Jazz,105,Los Angeles Clippers,98,7
1259,1259,Sun Apr 23 2017,Los Angeles Clippers,98,Utah Jazz,105,-7
2523,1260,Mon Apr 24 2017,Atlanta Hawks,111,Washington Wizards,101,10
1260,1260,Mon Apr 24 2017,Washington Wizards,101,Atlanta Hawks,111,-10
2524,1261,Mon Apr 24 2017,Portland Trail Blazers,103,Golden State Warriors,128,-25
1261,1261,Mon Apr 24 2017,Golden State Warriors,128,Portland Trail Blazers,103,25
1262,1262,Mon Apr 24 2017,Milwaukee Bucks,93,Toronto Raptors,118,-25
2525,1262,Mon Apr 24 2017,Toronto Raptors,118,Milwaukee Bucks,93,25
